ID,Флаг дозвона,Флаг продажи,Расходы,PV,NPV
0,1,0,23,0,-23
1,1,1,1883,1239,-644
2,0,0,135,0,-135
3,0,0,0,0,0
4,0,0,79,0,-79
5,0,0,136,0,-136
6,1,0,287,0,-287
7,1,0,3,0,-3
8,1,1,271,2063,1792
9,1,1,435,1219,784
10,1,1,439,2243,1804
11,1,0,29,0,-29
12,0,0,76,0,-76
13,1,1,1349,2152,803
14,0,0,23,0,-23
15,1,0,23,0,-23
16,1,0,23,0,-23
17,1,1,70,1702,1632
18,1,1,1121,1338,217
19,0,0,18,0,-18
20,1,1,72,1401,1329
21,1,0,18,0,-18
22,0,0,39,0,-39
23,1,0,107,0,-107
24,0,0,88,0,-88
25,0,0,36,0,-36
26,1,0,65,0,-65
27,1,0,69,0,-69
28,0,0,2,0,-2
29,0,0,67,0,-67
30,1,1,181,1887,1706
31,0,0,29,0,-29
32,1,1,1000,1735,735
33,0,0,20,0,-20
34,1,1,146,1364,1218
35,1,1,218,1223,1005
36,1,0,172,0,-172
37,0,0,72,0,-72
38,0,0,31,0,-31
39,1,1,430,2322,1892
40,0,0,15,0,-15
41,1,1,312,3209,2897
42,1,0,35,0,-35
43,1,1,421,1618,1197
44,0,0,95,0,-95
45,1,0,61,0,-61
46,1,1,263,2227,1964
47,0,0,4,0,-4
48,0,0,46,0,-46
49,0,0,82,0,-82
50,1,0,114,0,-114
51,1,1,348,1906,1558
52,1,0,22,0,-22
53,1,0,19,0,-19
54,1,1,644,1287,643
55,1,1,363,1403,1040
56,1,0,263,0,-263
57,1,0,41,0,-41
58,1,1,345,1313,968
59,0,0,46,0,-46
60,1,1,2112,1418,-694
61,1,1,525,2589,2064
62,0,0,11,0,-11
63,1,0,6,0,-6
64,1,1,751,1494,743
65,1,0,8,0,-8
66,1,0,108,0,-108
67,0,0,79,0,-79
68,1,0,93,0,-93
69,1,1,574,1228,654
70,1,0,2,0,-2
71,1,0,65,0,-65
72,0,0,28,0,-28
73,1,1,520,1382,862
74,1,0,10,0,-10
75,0,0,112,0,-112
76,0,0,26,0,-26
77,1,0,58,0,-58
78,1,1,961,1379,418
79,0,0,75,0,-75
80,0,0,184,0,-184
81,1,1,388,1313,925
82,0,0,2,0,-2
83,1,0,1,0,-1
84,0,0,87,0,-87
85,1,1,844,1700,856
86,1,1,456,1307,851
87,1,0,22,0,-22
88,0,0,35,0,-35
89,1,0,43,0,-43
90,0,0,49,0,-49
91,1,0,88,0,-88
92,1,1,630,1502,872
93,0,0,88,0,-88
94,0,0,35,0,-35
95,0,0,94,0,-94
96,1,1,1152,1857,705
97,1,0,55,0,-55
98,1,1,186,1262,1076
99,1,1,727,3816,3089
100,1,1,703,6492,5789
101,1,1,469,1590,1121
102,0,0,117,0,-117
103,0,0,32,0,-32
104,0,0,272,0,-272
105,0,0,69,0,-69
106,1,0,46,0,-46
107,0,0,83,0,-83
108,1,0,51,0,-51
109,1,0,24,0,-24
110,1,1,715,1391,676
111,0,0,29,0,-29
112,1,1,278,1432,1154
113,0,0,20,0,-20
114,0,0,48,0,-48
115,0,0,6,0,-6
116,0,0,2,0,-2
117,1,0,50,0,-50
118,0,0,0,0,0
119,1,0,11,0,-11
120,1,0,11,0,-11
121,0,0,86,0,-86
122,1,1,58,1443,1385
123,0,0,37,0,-37
124,1,0,153,0,-153
125,1,1,206,1602,1396
126,1,1,132,1290,1158
127,0,0,87,0,-87
128,1,0,1,0,-1
129,1,1,455,1238,783
130,0,0,46,0,-46
131,1,1,734,1318,584
132,0,0,12,0,-12
133,1,0,80,0,-80
134,0,0,12,0,-12
135,1,0,48,0,-48
136,0,0,220,0,-220
137,1,1,465,1346,881
138,1,1,75,1404,1329
139,1,0,46,0,-46
140,0,0,93,0,-93
141,0,0,8,0,-8
142,1,1,65,1231,1166
143,1,0,57,0,-57
144,0,0,0,0,0
145,1,1,217,1335,1118
146,1,1,1860,1473,-387
147,1,0,15,0,-15
148,1,1,372,2122,1750
149,1,0,19,0,-19
150,1,1,84,1749,1665
151,0,0,101,0,-101
152,0,0,53,0,-53
153,0,0,78,0,-78
154,1,0,25,0,-25
155,0,0,216,0,-216
156,1,0,1,0,-1
157,1,0,8,0,-8
158,1,0,21,0,-21
159,0,0,20,0,-20
160,1,0,23,0,-23
161,0,0,11,0,-11
162,1,1,39,1240,1201
163,0,0,80,0,-80
164,0,0,47,0,-47
165,0,0,19,0,-19
166,0,0,33,0,-33
167,1,1,847,1298,451
168,1,1,348,1219,871
169,1,0,97,0,-97
170,1,1,2512,1222,-1290
171,0,0,6,0,-6
172,1,0,23,0,-23
173,0,0,92,0,-92
174,0,0,14,0,-14
175,0,0,25,0,-25
176,1,1,342,1234,892
177,1,1,345,1262,917
178,1,1,599,1604,1005
179,1,0,48,0,-48
180,1,0,16,0,-16
181,0,0,135,0,-135
182,0,0,8,0,-8
183,0,0,5,0,-5
184,1,1,320,1348,1028
185,1,1,919,1439,520
186,0,0,4,0,-4
187,1,0,59,0,-59
188,1,0,61,0,-61
189,1,1,157,1945,1788
190,0,0,18,0,-18
191,1,0,18,0,-18
192,0,0,9,0,-9
193,1,1,1248,1230,-18
194,1,1,512,1438,926
195,0,0,23,0,-23
196,0,0,207,0,-207
197,0,0,17,0,-17
198,0,0,1,0,-1
199,1,1,782,1515,733
200,0,0,0,0,0
201,1,0,30,0,-30
202,1,1,539,1422,883
203,1,0,152,0,-152
204,1,1,154,1239,1085
205,0,0,20,0,-20
206,1,1,1238,1324,86
207,1,0,70,0,-70
208,1,0,0,0,0
209,0,0,29,0,-29
210,0,0,35,0,-35
211,1,1,637,1350,713
212,0,0,20,0,-20
213,1,0,210,0,-210
214,1,1,145,1431,1286
215,0,0,6,0,-6
216,1,0,39,0,-39
217,1,1,496,1216,720
218,1,1,121,1362,1241
219,1,0,74,0,-74
220,1,1,696,1296,600
221,0,0,41,0,-41
222,1,0,45,0,-45
223,1,0,7,0,-7
224,1,0,60,0,-60
225,0,0,63,0,-63
226,0,0,109,0,-109
227,0,0,129,0,-129
228,0,0,81,0,-81
229,1,1,546,1320,774
230,1,1,1081,1235,154
231,1,1,328,1582,1254
232,1,1,431,2019,1588
233,1,0,6,0,-6
234,1,1,160,2483,2323
235,1,0,21,0,-21
236,1,1,93,1476,1383
237,1,0,25,0,-25
238,1,1,79,1702,1623
239,0,0,25,0,-25
240,1,1,831,1498,667
241,1,0,38,0,-38
242,1,0,7,0,-7
243,0,0,72,0,-72
244,1,0,68,0,-68
245,1,1,481,1415,934
246,1,1,2196,1723,-473
247,1,1,216,1705,1489
248,1,0,47,0,-47
249,0,0,30,0,-30
250,0,0,58,0,-58
251,1,0,16,0,-16
252,0,0,5,0,-5
253,0,0,242,0,-242
254,1,0,24,0,-24
255,0,0,12,0,-12
256,1,1,515,1520,1005
257,1,0,12,0,-12
258,1,1,638,1254,616
259,0,0,2,0,-2
260,1,0,129,0,-129
261,0,0,28,0,-28
262,0,0,41,0,-41
263,1,0,110,0,-110
264,1,0,33,0,-33
265,0,0,104,0,-104
266,0,0,81,0,-81
267,0,0,39,0,-39
268,1,0,44,0,-44
269,1,1,179,1420,1241
270,0,0,126,0,-126
271,0,0,2,0,-2
272,0,0,26,0,-26
273,1,0,20,0,-20
274,1,0,10,0,-10
275,1,1,185,1635,1450
276,0,0,8,0,-8
277,1,0,31,0,-31
278,0,0,12,0,-12
279,0,0,49,0,-49
280,1,0,67,0,-67
281,0,0,131,0,-131
282,1,1,1003,1344,341
283,0,0,131,0,-131
284,1,0,84,0,-84
285,1,0,89,0,-89
286,0,0,69,0,-69
287,0,0,40,0,-40
288,1,0,2,0,-2
289,0,0,11,0,-11
290,0,0,28,0,-28
291,1,0,126,0,-126
292,0,0,111,0,-111
293,1,0,34,0,-34
294,1,1,875,2712,1837
295,1,1,92,1481,1389
296,0,0,1,0,-1
297,1,0,1,0,-1
298,0,0,8,0,-8
299,0,0,95,0,-95
300,0,0,9,0,-9
301,0,0,23,0,-23
302,1,0,79,0,-79
303,0,0,0,0,0
304,1,0,5,0,-5
305,1,0,10,0,-10
306,0,0,12,0,-12
307,0,0,141,0,-141
308,1,1,485,1304,819
309,1,1,65,1300,1235
310,0,0,26,0,-26
311,1,0,16,0,-16
312,1,0,42,0,-42
313,1,1,276,1256,980
314,1,0,5,0,-5
315,1,0,96,0,-96
316,1,0,0,0,0
317,0,0,15,0,-15
318,1,1,318,1390,1072
319,1,0,37,0,-37
320,0,0,70,0,-70
321,0,0,105,0,-105
322,1,1,330,2433,2103
323,1,0,73,0,-73
324,0,0,137,0,-137
325,1,1,893,1365,472
326,1,0,35,0,-35
327,1,0,65,0,-65
328,0,0,35,0,-35
329,1,1,848,1565,717
330,1,1,112,1218,1106
331,0,0,81,0,-81
332,0,0,13,0,-13
333,1,1,928,1564,636
334,1,1,755,1314,559
335,1,1,881,1276,395
336,1,0,0,0,0
337,0,0,36,0,-36
338,0,0,19,0,-19
339,0,0,8,0,-8
340,0,0,7,0,-7
341,1,0,26,0,-26
342,1,1,294,1635,1341
343,1,1,348,1438,1090
344,0,0,52,0,-52
345,1,0,22,0,-22
346,1,0,148,0,-148
347,1,0,38,0,-38
348,0,0,23,0,-23
349,1,1,378,1552,1174
350,1,0,10,0,-10
351,1,0,14,0,-14
352,1,0,12,0,-12
353,0,0,60,0,-60
354,0,0,75,0,-75
355,1,0,10,0,-10
356,0,0,9,0,-9
357,0,0,50,0,-50
358,1,1,373,1607,1234
359,0,0,21,0,-21
360,1,1,32,1331,1299
361,0,0,14,0,-14
362,0,0,69,0,-69
363,0,0,59,0,-59
364,1,1,453,1344,891
365,1,0,12,0,-12
366,1,1,1230,2329,1099
367,1,1,1116,1586,470
368,1,1,679,1253,574
369,0,0,75,0,-75
370,1,1,227,1525,1298
371,0,0,2,0,-2
372,1,1,632,1261,629
373,1,0,46,0,-46
374,0,0,41,0,-41
375,0,0,85,0,-85
376,1,0,28,0,-28
377,0,0,20,0,-20
378,1,0,14,0,-14
379,1,1,1295,1291,-4
380,0,0,100,0,-100
381,1,0,37,0,-37
382,0,0,45,0,-45
383,1,1,111,1756,1645
384,1,0,37,0,-37
385,1,1,522,2332,1810
386,0,0,43,0,-43
387,1,0,0,0,0
388,1,1,333,1209,876
389,0,0,81,0,-81
390,1,1,276,1983,1707
391,1,1,156,1319,1163
392,0,0,138,0,-138
393,1,0,26,0,-26
394,1,0,41,0,-41
395,1,0,17,0,-17
396,1,0,0,0,0
397,0,0,145,0,-145
398,0,0,5,0,-5
399,1,1,63,1303,1240
400,0,0,181,0,-181
401,1,1,435,2595,2160
402,0,0,31,0,-31
403,0,0,141,0,-141
404,1,0,101,0,-101
405,0,0,218,0,-218
406,1,0,54,0,-54
407,0,0,60,0,-60
408,0,0,31,0,-31
409,0,0,19,0,-19
410,1,1,559,1201,642
411,1,1,213,1520,1307
412,1,1,264,1494,1230
413,1,0,0,0,0
414,1,0,164,0,-164
415,0,0,106,0,-106
416,1,1,187,2339,2152
417,1,0,9,0,-9
418,1,0,46,0,-46
419,1,1,403,1285,882
420,0,0,55,0,-55
421,0,0,14,0,-14
422,0,0,55,0,-55
423,1,0,27,0,-27
424,0,0,5,0,-5
425,1,1,63,1224,1161
426,0,0,17,0,-17
427,1,1,679,1894,1215
428,1,1,794,1484,690
429,1,1,311,1239,928
430,1,1,624,1401,777
431,1,0,28,0,-28
432,0,0,121,0,-121
433,1,0,1,0,-1
434,1,1,826,1365,539
435,1,1,719,1550,831
436,0,0,80,0,-80
437,0,0,122,0,-122
438,0,0,92,0,-92
439,0,0,32,0,-32
440,1,1,592,1256,664
441,1,0,44,0,-44
442,1,1,1887,1450,-437
443,1,1,359,1281,922
444,1,0,6,0,-6
445,1,1,370,1734,1364
446,0,0,4,0,-4
447,1,1,448,2073,1625
448,1,1,224,1804,1580
449,0,0,28,0,-28
450,0,0,153,0,-153
451,1,0,200,0,-200
452,0,0,27,0,-27
453,0,0,82,0,-82
454,1,1,273,1358,1085
455,1,1,707,1260,553
456,1,0,314,0,-314
457,1,1,399,1691,1292
458,1,0,89,0,-89
459,1,0,17,0,-17
460,0,0,13,0,-13
461,0,0,21,0,-21
462,1,1,267,1670,1403
463,1,0,16,0,-16
464,0,0,79,0,-79
465,1,0,42,0,-42
466,0,0,164,0,-164
467,1,1,133,1416,1283
468,0,0,37,0,-37
469,0,0,16,0,-16
470,1,0,33,0,-33
471,0,0,97,0,-97
472,0,0,9,0,-9
473,0,0,90,0,-90
474,1,1,94,1206,1112
475,1,0,77,0,-77
476,0,0,2,0,-2
477,1,1,1031,1653,622
478,0,0,65,0,-65
479,0,0,74,0,-74
480,1,0,151,0,-151
481,1,1,96,1861,1765
482,1,0,9,0,-9
483,1,0,51,0,-51
484,0,0,62,0,-62
485,0,0,10,0,-10
486,1,1,1171,1318,147
487,0,0,188,0,-188
488,0,0,0,0,0
489,1,1,1273,2025,752
490,1,0,29,0,-29
491,1,1,908,1265,357
492,1,1,1372,1279,-93
493,0,0,29,0,-29
494,0,0,35,0,-35
495,1,0,75,0,-75
496,1,0,44,0,-44
497,0,0,21,0,-21
498,1,1,960,1232,272
499,1,0,15,0,-15
500,1,0,19,0,-19
501,1,0,254,0,-254
502,1,1,291,1208,917
503,0,0,308,0,-308
504,1,0,100,0,-100
505,1,0,152,0,-152
506,1,0,145,0,-145
507,0,0,130,0,-130
508,0,0,36,0,-36
509,1,0,66,0,-66
510,1,1,93,2651,2558
511,1,0,31,0,-31
512,0,0,11,0,-11
513,0,0,6,0,-6
514,0,0,137,0,-137
515,0,0,64,0,-64
516,1,0,2,0,-2
517,1,0,21,0,-21
518,1,1,615,1612,997
519,1,1,343,1950,1607
520,1,0,61,0,-61
521,1,0,71,0,-71
522,0,0,5,0,-5
523,0,0,46,0,-46
524,0,0,131,0,-131
525,1,1,616,1337,721
526,0,0,34,0,-34
527,0,0,24,0,-24
528,0,0,18,0,-18
529,1,1,950,1490,540
530,0,0,0,0,0
531,0,0,23,0,-23
532,0,0,46,0,-46
533,0,0,62,0,-62
534,1,0,10,0,-10
535,1,1,1010,1368,358
536,1,1,611,1212,601
537,1,0,114,0,-114
538,0,0,15,0,-15
539,1,1,588,1596,1008
540,0,0,32,0,-32
541,1,1,218,2114,1896
542,0,0,85,0,-85
543,0,0,6,0,-6
544,1,1,187,1392,1205
545,0,0,7,0,-7
546,1,1,760,1678,918
547,0,0,76,0,-76
548,0,0,30,0,-30
549,0,0,98,0,-98
550,1,0,18,0,-18
551,1,1,554,1318,764
552,0,0,141,0,-141
553,1,1,2176,1757,-419
554,1,0,31,0,-31
555,0,0,88,0,-88
556,1,1,292,1322,1030
557,1,1,1361,1638,277
558,1,0,18,0,-18
559,0,0,21,0,-21
560,1,1,59,2060,2001
561,0,0,56,0,-56
562,0,0,29,0,-29
563,1,0,1,0,-1
564,1,1,203,1327,1124
565,0,0,178,0,-178
566,1,1,614,1337,723
567,1,0,40,0,-40
568,1,1,468,1323,855
569,1,0,137,0,-137
570,0,0,155,0,-155
571,1,1,866,2255,1389
572,1,1,341,1823,1482
573,0,0,184,0,-184
574,1,0,12,0,-12
575,0,0,57,0,-57
576,1,0,56,0,-56
577,0,0,30,0,-30
578,1,0,68,0,-68
579,0,0,17,0,-17
580,1,1,304,1213,909
581,1,0,153,0,-153
582,0,0,133,0,-133
583,0,0,23,0,-23
584,0,0,0,0,0
585,1,0,15,0,-15
586,1,1,846,1481,635
587,0,0,37,0,-37
588,1,1,135,1335,1200
589,1,1,616,1303,687
590,1,1,489,1234,745
591,1,1,819,1365,546
592,1,0,24,0,-24
593,0,0,152,0,-152
594,0,0,110,0,-110
595,1,1,59,1493,1434
596,1,1,407,1224,817
597,1,0,0,0,0
598,0,0,19,0,-19
599,1,1,330,1249,919
600,1,1,451,1892,1441
601,0,0,17,0,-17
602,0,0,14,0,-14
603,1,0,13,0,-13
604,1,1,82,1429,1347
605,1,0,60,0,-60
606,1,0,7,0,-7
607,1,0,1,0,-1
608,1,1,64,1296,1232
609,1,1,112,1427,1315
610,1,0,32,0,-32
611,0,0,27,0,-27
612,1,1,244,1540,1296
613,1,1,299,1386,1087
614,0,0,6,0,-6
615,1,1,897,1253,356
616,0,0,126,0,-126
617,1,0,20,0,-20
618,1,0,67,0,-67
619,1,1,296,1690,1394
620,0,0,37,0,-37
621,0,0,131,0,-131
622,1,0,299,0,-299
623,0,0,2,0,-2
624,0,0,114,0,-114
625,0,0,109,0,-109
626,1,1,305,1237,932
627,0,0,70,0,-70
628,0,0,34,0,-34
629,0,0,23,0,-23
630,0,0,93,0,-93
631,1,0,5,0,-5
632,1,0,14,0,-14
633,1,1,336,1343,1007
634,1,1,62,1924,1862
635,1,1,360,1631,1271
636,1,1,545,1321,776
637,1,1,972,1225,253
638,0,0,54,0,-54
639,1,1,612,1382,770
640,0,0,158,0,-158
641,1,0,30,0,-30
642,1,1,91,1218,1127
643,0,0,86,0,-86
644,1,1,182,1243,1061
645,0,0,83,0,-83
646,0,0,82,0,-82
647,1,1,669,1361,692
648,0,0,20,0,-20
649,1,1,607,1862,1255
650,0,0,6,0,-6
651,1,1,536,2496,1960
652,1,1,1168,1411,243
653,0,0,39,0,-39
654,1,1,1185,1504,319
655,1,1,1395,1366,-29
656,0,0,43,0,-43
657,1,0,20,0,-20
658,1,1,387,1242,855
659,0,0,145,0,-145
660,0,0,58,0,-58
661,0,0,27,0,-27
662,1,1,450,1217,767
663,1,1,469,1287,818
664,0,0,38,0,-38
665,1,1,48,1227,1179
666,1,0,145,0,-145
667,1,1,554,1615,1061
668,0,0,9,0,-9
669,1,0,75,0,-75
670,1,1,144,1283,1139
671,0,0,10,0,-10
672,0,0,66,0,-66
673,1,0,43,0,-43
674,1,0,18,0,-18
675,0,0,14,0,-14
676,1,0,36,0,-36
677,0,0,11,0,-11
678,0,0,30,0,-30
679,1,0,46,0,-46
680,1,1,612,1370,758
681,1,1,267,1499,1232
682,0,0,5,0,-5
683,1,0,52,0,-52
684,1,1,820,1305,485
685,0,0,46,0,-46
686,1,1,720,1518,798
687,1,0,24,0,-24
688,1,0,29,0,-29
689,1,0,13,0,-13
690,0,0,1,0,-1
691,0,0,38,0,-38
692,0,0,49,0,-49
693,1,0,38,0,-38
694,0,0,30,0,-30
695,1,0,51,0,-51
696,0,0,4,0,-4
697,1,0,51,0,-51
698,0,0,43,0,-43
699,0,0,65,0,-65
700,1,1,271,1750,1479
701,1,1,1104,1905,801
702,0,0,111,0,-111
703,0,0,20,0,-20
704,1,0,38,0,-38
705,1,0,89,0,-89
706,0,0,1,0,-1
707,0,0,81,0,-81
708,0,0,8,0,-8
709,1,0,6,0,-6
710,0,0,32,0,-32
711,1,1,144,1618,1474
712,1,0,115,0,-115
713,1,1,210,1377,1167
714,0,0,37,0,-37
715,0,0,19,0,-19
716,1,1,156,1271,1115
717,1,1,1414,2652,1238
718,1,0,10,0,-10
719,1,0,84,0,-84
720,1,0,72,0,-72
721,0,0,28,0,-28
722,0,0,8,0,-8
723,1,1,356,2960,2604
724,1,0,32,0,-32
725,1,1,1099,1637,538
726,1,1,56,2002,1946
727,1,0,90,0,-90
728,1,1,705,1948,1243
729,1,1,43,1229,1186
730,1,0,2,0,-2
731,0,0,73,0,-73
732,1,1,700,1326,626
733,1,0,157,0,-157
734,1,1,454,1605,1151
735,1,0,168,0,-168
736,1,0,12,0,-12
737,1,0,103,0,-103
738,0,0,4,0,-4
739,1,0,76,0,-76
740,0,0,50,0,-50
741,0,0,120,0,-120
742,0,0,18,0,-18
743,1,1,1839,1580,-259
744,0,0,51,0,-51
745,1,1,1473,1307,-166
746,0,0,192,0,-192
747,1,1,135,3225,3090
748,0,0,5,0,-5
749,1,0,1,0,-1
750,1,1,324,3654,3330
751,1,0,23,0,-23
752,0,0,28,0,-28
753,0,0,16,0,-16
754,1,0,10,0,-10
755,0,0,41,0,-41
756,0,0,28,0,-28
757,0,0,80,0,-80
758,0,0,50,0,-50
759,1,1,516,1232,716
760,1,0,14,0,-14
761,1,1,1140,1251,111
762,0,0,100,0,-100
763,1,1,76,2023,1947
764,1,0,49,0,-49
765,1,0,60,0,-60
766,1,1,334,2204,1870
767,1,0,61,0,-61
768,1,1,1412,1391,-21
769,0,0,138,0,-138
770,0,0,8,0,-8
771,1,0,128,0,-128
772,0,0,16,0,-16
773,1,0,39,0,-39
774,0,0,157,0,-157
775,1,1,255,1449,1194
776,1,1,656,1331,675
777,0,0,20,0,-20
778,0,0,40,0,-40
779,1,1,164,1463,1299
780,0,0,16,0,-16
781,1,0,55,0,-55
782,0,0,37,0,-37
783,1,1,724,1670,946
784,1,0,9,0,-9
785,1,1,896,1756,860
786,0,0,7,0,-7
787,1,0,83,0,-83
788,0,0,50,0,-50
789,0,0,11,0,-11
790,1,1,168,2001,1833
791,0,0,154,0,-154
792,0,0,8,0,-8
793,0,0,9,0,-9
794,0,0,46,0,-46
795,0,0,48,0,-48
796,1,0,2,0,-2
797,1,1,1459,1313,-146
798,1,1,548,1559,1011
799,0,0,165,0,-165
800,1,1,730,2000,1270
801,1,1,164,1201,1037
802,1,0,26,0,-26
803,1,1,265,1259,994
804,1,0,1,0,-1
805,0,0,137,0,-137
806,1,1,282,1796,1514
807,1,1,160,1327,1167
808,1,0,59,0,-59
809,1,0,8,0,-8
810,1,0,99,0,-99
811,0,0,11,0,-11
812,1,0,60,0,-60
813,1,0,67,0,-67
814,0,0,8,0,-8
815,0,0,101,0,-101
816,0,0,72,0,-72
817,0,0,16,0,-16
818,0,0,32,0,-32
819,1,1,24,1435,1411
820,0,0,22,0,-22
821,0,0,5,0,-5
822,1,1,561,1202,641
823,1,1,187,1257,1070
824,0,0,10,0,-10
825,1,1,951,1416,465
826,0,0,75,0,-75
827,1,1,867,1264,397
828,1,0,51,0,-51
829,0,0,101,0,-101
830,1,0,8,0,-8
831,1,1,505,1440,935
832,1,1,374,1500,1126
833,1,0,56,0,-56
834,1,1,8,1719,1711
835,0,0,5,0,-5
836,1,0,2,0,-2
837,0,0,145,0,-145
838,1,0,72,0,-72
839,1,0,43,0,-43
840,0,0,39,0,-39
841,0,0,47,0,-47
842,1,1,20,1593,1573
843,0,0,10,0,-10
844,1,1,572,1534,962
845,0,0,91,0,-91
846,0,0,28,0,-28
847,1,0,23,0,-23
848,1,1,257,1207,950
849,1,1,530,1443,913
850,1,1,872,2106,1234
851,1,0,44,0,-44
852,1,0,200,0,-200
853,0,0,40,0,-40
854,1,0,1,0,-1
855,1,1,59,1259,1200
856,1,1,395,1309,914
857,0,0,110,0,-110
858,1,0,16,0,-16
859,0,0,5,0,-5
860,0,0,77,0,-77
861,1,1,827,1503,676
862,1,1,112,1303,1191
863,1,1,869,1751,882
864,1,1,92,1517,1425
865,0,0,14,0,-14
866,1,0,23,0,-23
867,1,1,157,1426,1269
868,0,0,14,0,-14
869,1,0,2,0,-2
870,1,1,545,1413,868
871,0,0,35,0,-35
872,1,1,248,1843,1595
873,1,0,5,0,-5
874,0,0,23,0,-23
875,1,1,842,1471,629
876,1,1,264,1573,1309
877,1,0,6,0,-6
878,1,1,84,2053,1969
879,1,0,20,0,-20
880,1,0,112,0,-112
881,1,0,0,0,0
882,0,0,125,0,-125
883,0,0,23,0,-23
884,1,1,814,1742,928
885,0,0,47,0,-47
886,1,1,88,1278,1190
887,0,0,287,0,-287
888,1,1,476,1324,848
889,0,0,33,0,-33
890,0,0,81,0,-81
891,0,0,15,0,-15
892,1,0,31,0,-31
893,1,1,634,1458,824
894,1,1,285,1765,1480
895,0,0,96,0,-96
896,1,1,538,1654,1116
897,1,0,40,0,-40
898,0,0,122,0,-122
899,1,0,22,0,-22
900,1,1,492,1234,742
901,1,1,358,1416,1058
902,1,1,954,1335,381
903,0,0,84,0,-84
904,1,0,29,0,-29
905,1,1,1825,1365,-460
906,0,0,6,0,-6
907,0,0,104,0,-104
908,1,1,534,1266,732
909,0,0,16,0,-16
910,1,1,191,1231,1040
911,0,0,78,0,-78
912,0,0,35,0,-35
913,1,1,487,1491,1004
914,0,0,2,0,-2
915,1,0,33,0,-33
916,0,0,25,0,-25
917,0,0,28,0,-28
918,0,0,24,0,-24
919,1,1,425,1253,828
920,1,0,17,0,-17
921,1,1,147,3398,3251
922,1,1,709,1537,828
923,1,1,225,1374,1149
924,1,0,105,0,-105
925,0,0,12,0,-12
926,1,1,871,2107,1236
927,1,0,31,0,-31
928,1,0,3,0,-3
929,1,0,22,0,-22
930,1,0,3,0,-3
931,0,0,20,0,-20
932,0,0,47,0,-47
933,1,0,80,0,-80
934,0,0,42,0,-42
935,0,0,1,0,-1
936,0,0,6,0,-6
937,1,1,896,1204,308
938,1,0,211,0,-211
939,1,1,1677,1254,-423
940,1,1,101,1214,1113
941,1,0,18,0,-18
942,1,0,17,0,-17
943,0,0,31,0,-31
944,1,0,8,0,-8
945,1,0,3,0,-3
946,0,0,56,0,-56
947,1,0,6,0,-6
948,0,0,84,0,-84
949,1,1,451,1357,906
950,0,0,3,0,-3
951,1,1,201,2058,1857
952,1,0,45,0,-45
953,1,1,993,1324,331
954,0,0,22,0,-22
955,1,0,206,0,-206
956,1,1,232,1255,1023
957,0,0,7,0,-7
958,1,1,57,1647,1590
959,1,0,22,0,-22
960,0,0,48,0,-48
961,0,0,94,0,-94
962,1,0,2,0,-2
963,0,0,58,0,-58
964,0,0,14,0,-14
965,1,1,251,1207,956
966,1,0,46,0,-46
967,1,0,33,0,-33
968,0,0,2,0,-2
969,0,0,1,0,-1
970,1,0,31,0,-31
971,0,0,15,0,-15
972,1,0,25,0,-25
973,1,1,686,1484,798
974,1,0,78,0,-78
975,1,0,127,0,-127
976,0,0,102,0,-102
977,0,0,63,0,-63
978,0,0,3,0,-3
979,0,0,86,0,-86
980,1,0,76,0,-76
981,1,0,23,0,-23
982,1,0,23,0,-23
983,1,0,12,0,-12
984,1,1,95,1591,1496
985,1,0,35,0,-35
986,1,1,509,1512,1003
987,0,0,0,0,0
988,1,1,636,1632,996
989,0,0,56,0,-56
990,1,0,41,0,-41
991,1,1,100,1719,1619
992,1,0,19,0,-19
993,1,1,119,1320,1201
994,1,1,33,1316,1283
995,1,1,54,1547,1493
996,0,0,32,0,-32
997,0,0,21,0,-21
998,1,0,24,0,-24
999,0,0,58,0,-58
1000,1,1,223,1263,1040
1001,1,0,27,0,-27
1002,1,0,99,0,-99
1003,1,1,426,1373,947
1004,1,0,58,0,-58
1005,1,1,272,1243,971
1006,0,0,83,0,-83
1007,0,0,30,0,-30
1008,0,0,6,0,-6
1009,1,1,407,1325,918
1010,0,0,80,0,-80
1011,1,1,126,1279,1153
1012,0,0,41,0,-41
1013,0,0,78,0,-78
1014,0,0,71,0,-71
1015,1,1,666,2469,1803
1016,0,0,6,0,-6
1017,1,0,71,0,-71
1018,0,0,7,0,-7
1019,0,0,94,0,-94
1020,1,1,1125,1268,143
1021,1,1,360,1339,979
1022,0,0,97,0,-97
1023,0,0,57,0,-57
1024,0,0,39,0,-39
1025,1,0,39,0,-39
1026,1,0,0,0,0
1027,1,1,43,1242,1199
1028,0,0,3,0,-3
1029,0,0,15,0,-15
1030,1,0,42,0,-42
1031,1,1,165,1460,1295
1032,1,1,483,1296,813
1033,1,1,690,1232,542
1034,1,1,477,2445,1968
1035,0,0,0,0,0
1036,1,1,994,1216,222
1037,1,0,31,0,-31
1038,1,1,537,1352,815
1039,1,1,265,1546,1281
1040,1,1,1536,1325,-211
1041,0,0,24,0,-24
1042,1,1,384,1615,1231
1043,1,1,777,1434,657
1044,1,1,125,1243,1118
1045,1,0,46,0,-46
1046,1,1,178,1542,1364
1047,0,0,78,0,-78
1048,0,0,186,0,-186
1049,1,1,730,1429,699
1050,1,1,387,1332,945
1051,0,0,58,0,-58
1052,0,0,21,0,-21
1053,1,0,9,0,-9
1054,1,0,27,0,-27
1055,1,1,690,1465,775
1056,1,0,20,0,-20
1057,1,0,10,0,-10
1058,1,1,167,1328,1161
1059,0,0,64,0,-64
1060,1,1,199,1234,1035
1061,1,1,210,1327,1117
1062,1,1,901,1315,414
1063,1,1,1104,1322,218
1064,0,0,32,0,-32
1065,1,0,98,0,-98
1066,1,1,864,1442,578
1067,0,0,7,0,-7
1068,0,0,15,0,-15
1069,1,1,462,1693,1231
1070,1,0,73,0,-73
1071,1,1,543,1420,877
1072,1,1,162,1838,1676
1073,1,1,64,1273,1209
1074,1,1,411,1375,964
1075,1,0,77,0,-77
1076,1,0,0,0,0
1077,1,0,71,0,-71
1078,1,1,398,2416,2018
1079,1,0,17,0,-17
1080,0,0,10,0,-10
1081,1,1,522,1517,995
1082,0,0,24,0,-24
1083,0,0,60,0,-60
1084,1,0,50,0,-50
1085,0,0,61,0,-61
1086,1,0,15,0,-15
1087,0,0,47,0,-47
1088,1,1,345,1218,873
1089,1,0,37,0,-37
1090,1,0,61,0,-61
1091,1,0,95,0,-95
1092,1,0,80,0,-80
1093,1,1,1486,1205,-281
1094,1,1,524,1226,702
1095,1,1,789,1201,412
1096,0,0,9,0,-9
1097,1,0,0,0,0
1098,1,1,118,1233,1115
1099,1,0,13,0,-13
1100,1,1,654,1945,1291
1101,1,0,19,0,-19
1102,1,1,1321,1267,-54
1103,1,1,280,2959,2679
1104,0,0,19,0,-19
1105,1,0,27,0,-27
1106,1,1,44,1283,1239
1107,1,0,11,0,-11
1108,1,1,344,1851,1507
1109,1,1,38,2366,2328
1110,1,1,42,1939,1897
1111,1,0,10,0,-10
1112,1,1,1667,1274,-393
1113,1,1,401,1626,1225
1114,1,0,82,0,-82
1115,0,0,144,0,-144
1116,1,1,536,1441,905
1117,1,1,601,2001,1400
1118,0,0,4,0,-4
1119,0,0,12,0,-12
1120,1,1,730,1627,897
1121,1,1,327,5984,5657
1122,1,1,511,2096,1585
1123,1,0,1,0,-1
1124,0,0,5,0,-5
1125,0,0,3,0,-3
1126,1,0,5,0,-5
1127,0,0,17,0,-17
1128,0,0,87,0,-87
1129,1,1,327,1246,919
1130,0,0,46,0,-46
1131,0,0,167,0,-167
1132,0,0,77,0,-77
1133,0,0,20,0,-20
1134,0,0,139,0,-139
1135,1,1,291,1433,1142
1136,1,1,1631,1878,247
1137,1,0,39,0,-39
1138,0,0,48,0,-48
1139,1,1,85,1480,1395
1140,1,1,213,1685,1472
1141,1,0,0,0,0
1142,1,1,855,1499,644
1143,1,0,2,0,-2
1144,0,0,140,0,-140
1145,0,0,11,0,-11
1146,0,0,33,0,-33
1147,1,1,106,1210,1104
1148,0,0,210,0,-210
1149,1,1,222,1225,1003
1150,0,0,75,0,-75
1151,0,0,113,0,-113
1152,1,1,139,1275,1136
1153,1,0,68,0,-68
1154,1,1,355,1994,1639
1155,0,0,94,0,-94
1156,1,0,49,0,-49
1157,0,0,32,0,-32
1158,1,1,16,1214,1198
1159,0,0,71,0,-71
1160,1,0,13,0,-13
1161,1,0,5,0,-5
1162,0,0,278,0,-278
1163,0,0,40,0,-40
1164,0,0,29,0,-29
1165,0,0,15,0,-15
1166,1,0,16,0,-16
1167,0,0,24,0,-24
1168,0,0,49,0,-49
1169,1,1,1033,3080,2047
1170,1,1,635,1232,597
1171,0,0,7,0,-7
1172,0,0,37,0,-37
1173,1,0,41,0,-41
1174,1,1,352,1843,1491
1175,0,0,90,0,-90
1176,0,0,27,0,-27
1177,0,0,52,0,-52
1178,1,0,46,0,-46
1179,1,0,23,0,-23
1180,0,0,77,0,-77
1181,0,0,1,0,-1
1182,1,1,101,1212,1111
1183,0,0,19,0,-19
1184,0,0,31,0,-31
1185,0,0,63,0,-63
1186,0,0,6,0,-6
1187,0,0,256,0,-256
1188,0,0,71,0,-71
1189,0,0,18,0,-18
1190,1,0,29,0,-29
1191,1,1,1357,1381,24
1192,1,0,7,0,-7
1193,0,0,205,0,-205
1194,1,0,67,0,-67
1195,0,0,53,0,-53
1196,0,0,63,0,-63
1197,1,0,8,0,-8
1198,1,0,99,0,-99
1199,1,1,238,1270,1032
1200,0,0,47,0,-47
1201,1,1,608,1251,643
1202,1,0,67,0,-67
1203,0,0,99,0,-99
1204,0,0,51,0,-51
1205,1,1,247,1262,1015
1206,1,1,173,1208,1035
1207,0,0,73,0,-73
1208,0,0,26,0,-26
1209,1,1,929,1527,598
1210,1,0,78,0,-78
1211,1,1,104,1513,1409
1212,0,0,57,0,-57
1213,0,0,99,0,-99
1214,1,0,41,0,-41
1215,0,0,124,0,-124
1216,1,1,1101,1589,488
1217,0,0,41,0,-41
1218,1,1,615,2185,1570
1219,0,0,21,0,-21
1220,0,0,10,0,-10
1221,1,0,41,0,-41
1222,1,1,2183,1712,-471
1223,0,0,106,0,-106
1224,1,0,72,0,-72
1225,1,1,1756,1999,243
1226,1,0,82,0,-82
1227,0,0,72,0,-72
1228,1,1,557,1371,814
1229,1,0,95,0,-95
1230,1,1,346,1475,1129
1231,1,0,37,0,-37
1232,1,1,320,1546,1226
1233,0,0,65,0,-65
1234,0,0,84,0,-84
1235,1,1,43,1506,1463
1236,1,0,70,0,-70
1237,0,0,21,0,-21
1238,1,0,87,0,-87
1239,0,0,74,0,-74
1240,1,0,31,0,-31
1241,1,1,938,1428,490
1242,0,0,46,0,-46
1243,0,0,6,0,-6
1244,1,0,51,0,-51
1245,0,0,172,0,-172
1246,1,1,181,3091,2910
1247,1,1,311,1312,1001
1248,1,0,84,0,-84
1249,0,0,18,0,-18
1250,1,0,26,0,-26
1251,1,0,3,0,-3
1252,0,0,87,0,-87
1253,0,0,15,0,-15
1254,0,0,45,0,-45
1255,1,0,19,0,-19
1256,1,1,376,1321,945
1257,0,0,22,0,-22
1258,0,0,26,0,-26
1259,1,1,656,1251,595
1260,0,0,119,0,-119
1261,1,0,48,0,-48
1262,1,0,7,0,-7
1263,1,1,287,1293,1006
1264,1,1,66,1293,1227
1265,1,0,6,0,-6
1266,1,0,3,0,-3
1267,0,0,50,0,-50
1268,0,0,15,0,-15
1269,0,0,1,0,-1
1270,1,1,936,1389,453
1271,1,1,428,1323,895
1272,0,0,1,0,-1
1273,0,0,82,0,-82
1274,1,0,15,0,-15
1275,1,1,237,1312,1075
1276,1,1,271,1442,1171
1277,1,1,735,1569,834
1278,0,0,7,0,-7
1279,1,0,57,0,-57
1280,1,1,291,1848,1557
1281,1,0,28,0,-28
1282,1,1,29,1695,1666
1283,1,0,18,0,-18
1284,0,0,64,0,-64
1285,1,1,220,1644,1424
1286,0,0,92,0,-92
1287,1,1,819,2033,1214
1288,1,1,376,1362,986
1289,0,0,94,0,-94
1290,1,1,385,1734,1349
1291,0,0,46,0,-46
1292,0,0,9,0,-9
1293,1,1,291,1265,974
1294,1,0,93,0,-93
1295,0,0,84,0,-84
1296,0,0,5,0,-5
1297,1,0,6,0,-6
1298,1,0,24,0,-24
1299,0,0,28,0,-28
1300,1,0,17,0,-17
1301,1,1,320,1228,908
1302,0,0,10,0,-10
1303,1,1,97,1290,1193
1304,0,0,75,0,-75
1305,1,1,264,1280,1016
1306,1,0,14,0,-14
1307,1,0,87,0,-87
1308,1,0,55,0,-55
1309,0,0,77,0,-77
1310,0,0,42,0,-42
1311,1,1,93,1509,1416
1312,1,0,37,0,-37
1313,1,1,501,1423,922
1314,1,1,305,1775,1470
1315,0,0,7,0,-7
1316,1,1,966,1302,336
1317,1,1,40,1484,1444
1318,1,0,10,0,-10
1319,1,0,23,0,-23
1320,1,1,504,1400,896
1321,0,0,5,0,-5
1322,1,1,535,1236,701
1323,0,0,46,0,-46
1324,0,0,190,0,-190
1325,1,1,721,1214,493
1326,1,1,70,1398,1328
1327,1,0,10,0,-10
1328,1,0,28,0,-28
1329,1,1,213,1459,1246
1330,1,0,73,0,-73
1331,1,1,2280,1833,-447
1332,0,0,19,0,-19
1333,0,0,131,0,-131
1334,1,1,288,1545,1257
1335,1,0,67,0,-67
1336,1,0,38,0,-38
1337,1,0,43,0,-43
1338,1,0,105,0,-105
1339,0,0,9,0,-9
1340,1,1,442,1219,777
1341,1,0,4,0,-4
1342,1,0,225,0,-225
1343,1,0,60,0,-60
1344,1,1,120,1721,1601
1345,1,0,65,0,-65
1346,1,1,1155,1273,118
1347,1,0,16,0,-16
1348,0,0,6,0,-6
1349,1,1,127,1247,1120
1350,0,0,39,0,-39
1351,0,0,18,0,-18
1352,1,1,20,1642,1622
1353,1,0,35,0,-35
1354,1,1,556,1201,645
1355,0,0,29,0,-29
1356,0,0,15,0,-15
1357,0,0,17,0,-17
1358,1,1,450,1300,850
1359,0,0,13,0,-13
1360,0,0,9,0,-9
1361,1,1,80,1416,1336
1362,1,0,10,0,-10
1363,0,0,9,0,-9
1364,0,0,56,0,-56
1365,1,1,507,3123,2616
1366,0,0,80,0,-80
1367,0,0,7,0,-7
1368,0,0,23,0,-23
1369,1,1,419,1390,971
1370,0,0,64,0,-64
1371,1,1,1213,1742,529
1372,0,0,2,0,-2
1373,1,0,2,0,-2
1374,0,0,11,0,-11
1375,1,1,165,4073,3908
1376,1,1,162,1576,1414
1377,0,0,34,0,-34
1378,1,1,508,1373,865
1379,1,0,42,0,-42
1380,1,0,1,0,-1
1381,0,0,5,0,-5
1382,1,1,1099,1878,779
1383,0,0,0,0,0
1384,1,1,340,1223,883
1385,0,0,76,0,-76
1386,1,0,102,0,-102
1387,0,0,59,0,-59
1388,1,1,721,1779,1058
1389,1,0,55,0,-55
1390,1,0,10,0,-10
1391,1,1,1749,1573,-176
1392,1,1,204,2309,2105
1393,0,0,4,0,-4
1394,1,1,1408,1546,138
1395,0,0,57,0,-57
1396,1,1,1085,1461,376
1397,1,1,309,1449,1140
1398,1,0,29,0,-29
1399,1,1,265,1589,1324
1400,1,1,245,1544,1299
1401,0,0,85,0,-85
1402,1,0,13,0,-13
1403,1,1,1067,1405,338
1404,0,0,52,0,-52
1405,1,0,16,0,-16
1406,1,1,486,1535,1049
1407,1,0,18,0,-18
1408,0,0,0,0,0
1409,1,0,34,0,-34
1410,0,0,39,0,-39
1411,1,0,18,0,-18
1412,1,0,43,0,-43
1413,0,0,34,0,-34
1414,1,1,33,2298,2265
1415,0,0,31,0,-31
1416,0,0,2,0,-2
1417,0,0,15,0,-15
1418,0,0,111,0,-111
1419,0,0,31,0,-31
1420,0,0,53,0,-53
1421,0,0,60,0,-60
1422,0,0,132,0,-132
1423,0,0,57,0,-57
1424,0,0,6,0,-6
1425,1,0,76,0,-76
1426,0,0,8,0,-8
1427,1,1,329,1368,1039
1428,1,0,100,0,-100
1429,0,0,48,0,-48
1430,1,1,230,1476,1246
1431,0,0,13,0,-13
1432,1,1,193,2309,2116
1433,0,0,60,0,-60
1434,0,0,24,0,-24
1435,1,1,1459,1715,256
1436,0,0,64,0,-64
1437,1,1,114,1513,1399
1438,0,0,3,0,-3
1439,1,0,53,0,-53
1440,0,0,33,0,-33
1441,1,0,38,0,-38
1442,1,1,431,1918,1487
1443,1,0,139,0,-139
1444,0,0,127,0,-127
1445,1,0,30,0,-30
1446,1,0,84,0,-84
1447,1,1,76,1469,1393
1448,0,0,37,0,-37
1449,1,0,126,0,-126
1450,1,0,27,0,-27
1451,0,0,18,0,-18
1452,1,0,5,0,-5
1453,0,0,120,0,-120
1454,1,0,166,0,-166
1455,1,0,61,0,-61
1456,1,1,461,1589,1128
1457,1,0,55,0,-55
1458,1,0,0,0,0
1459,1,0,110,0,-110
1460,1,1,682,1444,762
1461,1,1,215,1828,1613
1462,1,0,2,0,-2
1463,1,0,142,0,-142
1464,1,1,148,1571,1423
1465,1,0,31,0,-31
1466,1,1,743,1271,528
1467,1,1,1199,1206,7
1468,0,0,39,0,-39
1469,1,0,103,0,-103
1470,1,1,182,1409,1227
1471,0,0,63,0,-63
1472,0,0,123,0,-123
1473,0,0,18,0,-18
1474,0,0,56,0,-56
1475,0,0,7,0,-7
1476,1,0,15,0,-15
1477,0,0,137,0,-137
1478,1,1,1055,1389,334
1479,1,0,86,0,-86
1480,1,0,14,0,-14
1481,1,1,432,1361,929
1482,0,0,9,0,-9
1483,0,0,62,0,-62
1484,1,1,106,1312,1206
1485,1,0,15,0,-15
1486,1,0,42,0,-42
1487,0,0,7,0,-7
1488,0,0,31,0,-31
1489,1,0,24,0,-24
1490,0,0,46,0,-46
1491,1,0,28,0,-28
1492,0,0,18,0,-18
1493,1,0,87,0,-87
1494,0,0,55,0,-55
1495,1,1,463,1434,971
1496,1,0,6,0,-6
1497,0,0,19,0,-19
1498,1,1,1832,1272,-560
1499,0,0,23,0,-23
1500,1,1,199,1247,1048
1501,0,0,37,0,-37
1502,1,0,68,0,-68
1503,1,0,26,0,-26
1504,1,0,11,0,-11
1505,0,0,39,0,-39
1506,0,0,16,0,-16
1507,0,0,38,0,-38
1508,0,0,30,0,-30
1509,1,1,454,1235,781
1510,0,0,75,0,-75
1511,0,0,54,0,-54
1512,0,0,22,0,-22
1513,0,0,60,0,-60
1514,0,0,88,0,-88
1515,1,0,54,0,-54
1516,0,0,84,0,-84
1517,0,0,7,0,-7
1518,0,0,142,0,-142
1519,1,1,712,1292,580
1520,0,0,29,0,-29
1521,1,0,19,0,-19
1522,1,1,961,1964,1003
1523,1,1,64,1665,1601
1524,1,0,5,0,-5
1525,0,0,61,0,-61
1526,1,0,23,0,-23
1527,1,1,69,1350,1281
1528,1,1,70,2589,2519
1529,1,0,23,0,-23
1530,1,0,111,0,-111
1531,1,1,34,2581,2547
1532,0,0,33,0,-33
1533,1,1,2007,1540,-467
1534,1,0,3,0,-3
1535,1,1,138,1494,1356
1536,1,1,1290,1240,-50
1537,0,0,14,0,-14
1538,0,0,32,0,-32
1539,1,1,204,1393,1189
1540,0,0,44,0,-44
1541,1,0,17,0,-17
1542,0,0,24,0,-24
1543,0,0,20,0,-20
1544,1,1,360,1222,862
1545,1,0,2,0,-2
1546,1,1,696,1557,861
1547,1,0,17,0,-17
1548,0,0,97,0,-97
1549,0,0,47,0,-47
1550,1,0,168,0,-168
1551,0,0,13,0,-13
1552,0,0,9,0,-9
1553,0,0,142,0,-142
1554,1,0,83,0,-83
1555,0,0,0,0,0
1556,0,0,80,0,-80
1557,1,0,39,0,-39
1558,1,0,88,0,-88
1559,0,0,14,0,-14
1560,1,1,250,1853,1603
1561,1,1,33,1234,1201
1562,1,1,639,1259,620
1563,0,0,4,0,-4
1564,1,1,62,2003,1941
1565,1,1,715,2033,1318
1566,0,0,32,0,-32
1567,0,0,181,0,-181
1568,0,0,1,0,-1
1569,1,0,10,0,-10
1570,1,0,1,0,-1
1571,1,0,111,0,-111
1572,1,0,116,0,-116
1573,0,0,50,0,-50
1574,1,1,254,1653,1399
1575,0,0,132,0,-132
1576,1,1,86,2084,1998
1577,1,0,17,0,-17
1578,1,1,88,1627,1539
1579,0,0,84,0,-84
1580,0,0,52,0,-52
1581,0,0,13,0,-13
1582,1,0,69,0,-69
1583,0,0,31,0,-31
1584,0,0,86,0,-86
1585,0,0,143,0,-143
1586,1,1,843,1223,380
1587,0,0,27,0,-27
1588,1,1,191,1363,1172
1589,1,1,526,1210,684
1590,1,0,6,0,-6
1591,0,0,122,0,-122
1592,1,1,142,1291,1149
1593,0,0,4,0,-4
1594,1,1,968,2146,1178
1595,0,0,2,0,-2
1596,0,0,88,0,-88
1597,1,0,91,0,-91
1598,1,0,125,0,-125
1599,1,1,825,1334,509
1600,0,0,5,0,-5
1601,0,0,11,0,-11
1602,0,0,54,0,-54
1603,0,0,2,0,-2
1604,1,0,44,0,-44
1605,0,0,26,0,-26
1606,0,0,120,0,-120
1607,1,1,104,1227,1123
1608,1,0,7,0,-7
1609,1,1,270,1933,1663
1610,0,0,2,0,-2
1611,0,0,35,0,-35
1612,1,0,46,0,-46
1613,0,0,49,0,-49
1614,0,0,4,0,-4
1615,1,1,901,1212,311
1616,1,1,535,1485,950
1617,1,0,51,0,-51
1618,0,0,5,0,-5
1619,1,1,677,1243,566
1620,1,1,84,1364,1280
1621,0,0,23,0,-23
1622,0,0,0,0,0
1623,1,1,911,2163,1252
1624,0,0,70,0,-70
1625,1,1,324,1261,937
1626,0,0,180,0,-180
1627,1,0,41,0,-41
1628,1,0,36,0,-36
1629,1,1,1012,1246,234
1630,0,0,68,0,-68
1631,1,1,682,1681,999
1632,1,1,703,1378,675
1633,0,0,52,0,-52
1634,0,0,51,0,-51
1635,1,1,552,1706,1154
1636,1,0,5,0,-5
1637,0,0,1,0,-1
1638,0,0,77,0,-77
1639,1,1,449,1342,893
1640,1,0,26,0,-26
1641,0,0,44,0,-44
1642,0,0,109,0,-109
1643,1,0,28,0,-28
1644,1,0,23,0,-23
1645,1,1,1508,1314,-194
1646,0,0,31,0,-31
1647,1,1,856,1355,499
1648,0,0,41,0,-41
1649,0,0,7,0,-7
1650,1,1,104,1589,1485
1651,1,0,23,0,-23
1652,1,1,1233,1531,298
1653,1,0,78,0,-78
1654,1,0,33,0,-33
1655,1,0,24,0,-24
1656,0,0,1,0,-1
1657,1,1,431,1206,775
1658,0,0,4,0,-4
1659,0,0,6,0,-6
1660,1,1,1038,2018,980
1661,1,1,705,1231,526
1662,1,0,13,0,-13
1663,0,0,17,0,-17
1664,0,0,28,0,-28
1665,0,0,12,0,-12
1666,0,0,10,0,-10
1667,1,0,5,0,-5
1668,1,0,10,0,-10
1669,1,0,17,0,-17
1670,1,1,541,2087,1546
1671,0,0,79,0,-79
1672,1,0,62,0,-62
1673,1,1,364,1421,1057
1674,1,1,122,1412,1290
1675,0,0,60,0,-60
1676,0,0,118,0,-118
1677,1,0,64,0,-64
1678,1,0,23,0,-23
1679,1,1,1938,1233,-705
1680,1,0,69,0,-69
1681,1,0,67,0,-67
1682,0,0,39,0,-39
1683,1,1,1768,1271,-497
1684,1,1,244,1980,1736
1685,1,0,17,0,-17
1686,0,0,74,0,-74
1687,1,1,360,4252,3892
1688,1,0,13,0,-13
1689,0,0,131,0,-131
1690,0,0,77,0,-77
1691,0,0,28,0,-28
1692,1,1,1109,1205,96
1693,0,0,4,0,-4
1694,1,0,67,0,-67
1695,0,0,14,0,-14
1696,0,0,17,0,-17
1697,1,1,3244,1441,-1803
1698,1,1,42,2375,2333
1699,0,0,49,0,-49
1700,0,0,16,0,-16
1701,0,0,249,0,-249
1702,1,0,18,0,-18
1703,1,1,308,3114,2806
1704,1,0,94,0,-94
1705,0,0,2,0,-2
1706,1,0,7,0,-7
1707,1,1,313,2003,1690
1708,1,0,54,0,-54
1709,1,1,800,1386,586
1710,1,0,116,0,-116
1711,0,0,8,0,-8
1712,0,0,47,0,-47
1713,1,1,3699,1537,-2162
1714,0,0,22,0,-22
1715,0,0,26,0,-26
1716,1,1,739,1423,684
1717,0,0,35,0,-35
1718,0,0,19,0,-19
1719,0,0,224,0,-224
1720,1,1,387,1289,902
1721,1,0,1,0,-1
1722,1,0,2,0,-2
1723,0,0,118,0,-118
1724,0,0,1,0,-1
1725,0,0,25,0,-25
1726,0,0,18,0,-18
1727,0,0,0,0,0
1728,1,0,144,0,-144
1729,0,0,33,0,-33
1730,0,0,36,0,-36
1731,1,1,468,1988,1520
1732,1,1,191,1232,1041
1733,0,0,25,0,-25
1734,1,0,77,0,-77
1735,1,1,370,1351,981
1736,0,0,71,0,-71
1737,1,1,278,1535,1257
1738,0,0,54,0,-54
1739,0,0,43,0,-43
1740,0,0,32,0,-32
1741,1,1,137,1267,1130
1742,0,0,10,0,-10
1743,1,1,258,1362,1104
1744,0,0,19,0,-19
1745,1,0,41,0,-41
1746,1,0,93,0,-93
1747,0,0,126,0,-126
1748,0,0,10,0,-10
1749,0,0,88,0,-88
1750,1,1,246,1527,1281
1751,1,1,152,1566,1414
1752,1,1,127,1308,1181
1753,0,0,31,0,-31
1754,1,0,18,0,-18
1755,0,0,4,0,-4
1756,1,1,164,1272,1108
1757,0,0,79,0,-79
1758,1,0,15,0,-15
1759,1,0,95,0,-95
1760,1,0,35,0,-35
1761,1,1,2078,1885,-193
1762,1,1,974,1434,460
1763,0,0,52,0,-52
1764,1,1,917,2589,1672
1765,1,0,40,0,-40
1766,0,0,17,0,-17
1767,1,1,440,1348,908
1768,1,1,16,1487,1471
1769,0,0,39,0,-39
1770,1,1,200,1387,1187
1771,1,1,972,1334,362
1772,1,0,74,0,-74
1773,1,0,98,0,-98
1774,0,0,32,0,-32
1775,0,0,0,0,0
1776,1,1,61,1677,1616
1777,0,0,75,0,-75
1778,0,0,60,0,-60
1779,0,0,31,0,-31
1780,1,1,328,1764,1436
1781,0,0,48,0,-48
1782,1,0,3,0,-3
1783,0,0,34,0,-34
1784,0,0,64,0,-64
1785,1,0,11,0,-11
1786,0,0,8,0,-8
1787,1,1,642,1316,674
1788,0,0,327,0,-327
1789,0,0,20,0,-20
1790,0,0,5,0,-5
1791,0,0,3,0,-3
1792,1,1,429,1577,1148
1793,0,0,11,0,-11
1794,1,0,42,0,-42
1795,1,0,67,0,-67
1796,0,0,73,0,-73
1797,0,0,45,0,-45
1798,1,1,544,1376,832
1799,1,0,27,0,-27
1800,1,1,126,1679,1553
1801,1,0,40,0,-40
1802,0,0,93,0,-93
1803,1,0,10,0,-10
1804,1,1,1644,2049,405
1805,1,1,600,1378,778
1806,1,0,18,0,-18
1807,1,1,2575,1403,-1172
1808,0,0,20,0,-20
1809,0,0,8,0,-8
1810,1,1,979,1241,262
1811,1,0,46,0,-46
1812,0,0,24,0,-24
1813,0,0,14,0,-14
1814,1,0,111,0,-111
1815,1,0,110,0,-110
1816,0,0,33,0,-33
1817,0,0,1,0,-1
1818,0,0,10,0,-10
1819,0,0,5,0,-5
1820,1,1,179,1251,1072
1821,1,1,147,1515,1368
1822,0,0,131,0,-131
1823,1,0,6,0,-6
1824,1,0,19,0,-19
1825,1,1,489,1332,843
1826,1,0,15,0,-15
1827,0,0,90,0,-90
1828,1,0,75,0,-75
1829,0,0,55,0,-55
1830,0,0,151,0,-151
1831,0,0,106,0,-106
1832,1,0,1,0,-1
1833,0,0,169,0,-169
1834,1,1,1623,1720,97
1835,1,1,53,1859,1806
1836,1,0,20,0,-20
1837,0,0,30,0,-30
1838,0,0,29,0,-29
1839,1,1,829,1309,480
1840,1,0,71,0,-71
1841,0,0,302,0,-302
1842,1,1,166,1665,1499
1843,1,0,82,0,-82
1844,1,0,3,0,-3
1845,1,0,8,0,-8
1846,0,0,158,0,-158
1847,1,0,3,0,-3
1848,1,0,22,0,-22
1849,1,0,75,0,-75
1850,1,0,12,0,-12
1851,0,0,7,0,-7
1852,1,0,53,0,-53
1853,0,0,23,0,-23
1854,1,0,89,0,-89
1855,1,0,151,0,-151
1856,1,1,1111,1312,201
1857,1,0,101,0,-101
1858,1,0,1,0,-1
1859,1,0,94,0,-94
1860,1,1,498,1215,717
1861,1,1,473,1564,1091
1862,1,1,563,1649,1086
1863,1,1,153,1392,1239
1864,0,0,16,0,-16
1865,0,0,69,0,-69
1866,1,1,280,1322,1042
1867,1,0,76,0,-76
1868,1,0,5,0,-5
1869,1,0,16,0,-16
1870,0,0,21,0,-21
1871,0,0,119,0,-119
1872,1,1,124,1647,1523
1873,0,0,51,0,-51
1874,0,0,97,0,-97
1875,1,1,345,1542,1197
1876,0,0,74,0,-74
1877,1,0,38,0,-38
1878,1,1,1184,1656,472
1879,0,0,96,0,-96
1880,1,1,88,1475,1387
1881,0,0,35,0,-35
1882,1,0,48,0,-48
1883,0,0,23,0,-23
1884,1,1,294,1247,953
1885,1,0,8,0,-8
1886,1,1,147,1897,1750
1887,1,0,15,0,-15
1888,0,0,2,0,-2
1889,1,0,15,0,-15
1890,1,0,161,0,-161
1891,0,0,53,0,-53
1892,1,1,1274,1203,-71
1893,0,0,155,0,-155
1894,1,0,9,0,-9
1895,1,1,86,2007,1921
1896,0,0,90,0,-90
1897,0,0,111,0,-111
1898,0,0,25,0,-25
1899,1,0,20,0,-20
1900,0,0,86,0,-86
1901,0,0,180,0,-180
1902,0,0,111,0,-111
1903,1,0,1,0,-1
1904,1,1,275,1374,1099
1905,1,0,7,0,-7
1906,0,0,56,0,-56
1907,1,0,5,0,-5
1908,1,1,161,1206,1045
1909,1,0,75,0,-75
1910,0,0,11,0,-11
1911,1,0,40,0,-40
1912,1,1,242,2381,2139
1913,1,1,158,1279,1121
1914,0,0,9,0,-9
1915,0,0,109,0,-109
1916,1,0,1,0,-1
1917,0,0,5,0,-5
1918,1,1,467,1569,1102
1919,1,0,168,0,-168
1920,0,0,27,0,-27
1921,1,1,528,1229,701
1922,1,0,3,0,-3
1923,1,0,109,0,-109
1924,0,0,12,0,-12
1925,0,0,17,0,-17
1926,0,0,3,0,-3
1927,1,0,9,0,-9
1928,1,1,1142,1372,230
1929,0,0,17,0,-17
1930,1,1,559,1496,937
1931,0,0,4,0,-4
1932,1,0,26,0,-26
1933,1,1,113,1385,1272
1934,0,0,79,0,-79
1935,1,1,499,1240,741
1936,1,0,68,0,-68
1937,1,0,5,0,-5
1938,1,0,12,0,-12
1939,1,1,94,1324,1230
1940,0,0,0,0,0
1941,1,0,14,0,-14
1942,0,0,72,0,-72
1943,1,1,52,1255,1203
1944,0,0,65,0,-65
1945,1,0,112,0,-112
1946,0,0,81,0,-81
1947,0,0,21,0,-21
1948,1,1,576,1466,890
1949,0,0,139,0,-139
1950,1,0,90,0,-90
1951,0,0,30,0,-30
1952,1,1,274,2490,2216
1953,1,0,56,0,-56
1954,1,1,258,1487,1229
1955,1,1,1786,1338,-448
1956,0,0,21,0,-21
1957,1,1,407,1284,877
1958,1,1,3052,1281,-1771
1959,0,0,23,0,-23
1960,1,1,186,1422,1236
1961,0,0,3,0,-3
1962,0,0,72,0,-72
1963,0,0,9,0,-9
1964,0,0,48,0,-48
1965,1,0,38,0,-38
1966,0,0,267,0,-267
1967,0,0,235,0,-235
1968,1,1,120,1200,1080
1969,1,1,182,1921,1739
1970,1,1,604,1210,606
1971,1,1,1730,1813,83
1972,0,0,39,0,-39
1973,1,0,2,0,-2
1974,0,0,92,0,-92
1975,1,1,500,1467,967
1976,0,0,2,0,-2
1977,1,0,105,0,-105
1978,0,0,10,0,-10
1979,1,0,9,0,-9
1980,0,0,14,0,-14
1981,1,0,18,0,-18
1982,0,0,43,0,-43
1983,0,0,1,0,-1
1984,0,0,56,0,-56
1985,1,0,26,0,-26
1986,1,0,161,0,-161
1987,0,0,50,0,-50
1988,0,0,233,0,-233
1989,1,1,337,1293,956
1990,0,0,3,0,-3
1991,1,1,227,1558,1331
1992,1,0,2,0,-2
1993,0,0,202,0,-202
1994,1,1,437,1317,880
1995,1,0,28,0,-28
1996,1,0,30,0,-30
1997,0,0,8,0,-8
1998,1,1,48,1393,1345
1999,0,0,98,0,-98
2000,0,0,3,0,-3
2001,1,1,82,2072,1990
2002,1,1,319,2393,2074
2003,0,0,42,0,-42
2004,1,1,103,1409,1306
2005,0,0,151,0,-151
2006,1,1,157,1294,1137
2007,1,0,63,0,-63
2008,0,0,17,0,-17
2009,0,0,0,0,0
2010,1,0,33,0,-33
2011,1,1,261,1869,1608
2012,0,0,67,0,-67
2013,1,0,7,0,-7
2014,0,0,14,0,-14
2015,0,0,61,0,-61
2016,1,0,29,0,-29
2017,1,0,42,0,-42
2018,1,0,9,0,-9
2019,0,0,67,0,-67
2020,1,1,305,1265,960
2021,0,0,44,0,-44
2022,0,0,40,0,-40
2023,1,0,192,0,-192
2024,0,0,13,0,-13
2025,1,1,1023,1290,267
2026,1,0,93,0,-93
2027,0,0,42,0,-42
2028,1,0,17,0,-17
2029,1,0,2,0,-2
2030,1,1,622,1911,1289
2031,1,1,164,1471,1307
2032,0,0,32,0,-32
2033,1,0,122,0,-122
2034,1,0,55,0,-55
2035,0,0,40,0,-40
2036,1,0,84,0,-84
2037,1,0,68,0,-68
2038,0,0,20,0,-20
2039,1,0,60,0,-60
2040,1,0,37,0,-37
2041,1,1,981,1784,803
2042,0,0,26,0,-26
2043,0,0,12,0,-12
2044,0,0,22,0,-22
2045,1,0,17,0,-17
2046,0,0,31,0,-31
2047,1,1,184,1428,1244
2048,0,0,5,0,-5
2049,0,0,44,0,-44
2050,0,0,7,0,-7
2051,1,1,424,1371,947
2052,0,0,9,0,-9
2053,0,0,5,0,-5
2054,1,1,1326,1202,-124
2055,1,0,23,0,-23
2056,1,0,191,0,-191
2057,1,0,24,0,-24
2058,0,0,4,0,-4
2059,1,0,10,0,-10
2060,1,1,848,1210,362
2061,1,1,757,1485,728
2062,0,0,76,0,-76
2063,1,0,43,0,-43
2064,0,0,42,0,-42
2065,0,0,41,0,-41
2066,0,0,135,0,-135
2067,1,0,20,0,-20
2068,0,0,39,0,-39
2069,1,0,28,0,-28
2070,1,0,16,0,-16
2071,0,0,20,0,-20
2072,1,1,536,1501,965
2073,1,1,120,1889,1769
2074,1,0,133,0,-133
2075,1,0,3,0,-3
2076,1,1,637,1244,607
2077,1,1,591,1327,736
2078,0,0,6,0,-6
2079,0,0,16,0,-16
2080,0,0,4,0,-4
2081,1,0,46,0,-46
2082,1,0,82,0,-82
2083,1,1,1777,1449,-328
2084,0,0,77,0,-77
2085,0,0,21,0,-21
2086,0,0,94,0,-94
2087,1,1,153,1248,1095
2088,0,0,40,0,-40
2089,1,1,362,1313,951
2090,1,0,33,0,-33
2091,1,0,76,0,-76
2092,0,0,0,0,0
2093,0,0,35,0,-35
2094,0,0,19,0,-19
2095,1,1,318,1601,1283
2096,0,0,139,0,-139
2097,0,0,69,0,-69
2098,1,1,198,2013,1815
2099,1,1,261,1445,1184
2100,1,0,55,0,-55
2101,1,0,304,0,-304
2102,1,0,5,0,-5
2103,0,0,35,0,-35
2104,1,0,108,0,-108
2105,0,0,45,0,-45
2106,0,0,8,0,-8
2107,0,0,2,0,-2
2108,1,0,32,0,-32
2109,0,0,1,0,-1
2110,0,0,30,0,-30
2111,1,1,99,1619,1520
2112,1,0,51,0,-51
2113,0,0,35,0,-35
2114,1,0,91,0,-91
2115,1,1,891,1390,499
2116,0,0,6,0,-6
2117,0,0,21,0,-21
2118,0,0,26,0,-26
2119,0,0,94,0,-94
2120,1,1,1271,1474,203
2121,0,0,62,0,-62
2122,1,0,184,0,-184
2123,0,0,37,0,-37
2124,0,0,207,0,-207
2125,1,0,112,0,-112
2126,1,1,225,1652,1427
2127,1,0,15,0,-15
2128,0,0,24,0,-24
2129,1,1,1250,1516,266
2130,1,0,6,0,-6
2131,1,1,151,1369,1218
2132,0,0,4,0,-4
2133,0,0,116,0,-116
2134,1,1,48,1866,1818
2135,1,1,334,1296,962
2136,0,0,49,0,-49
2137,1,1,1304,2144,840
2138,0,0,174,0,-174
2139,1,1,317,1218,901
2140,1,1,289,1780,1491
2141,1,1,401,1930,1529
2142,1,0,25,0,-25
2143,0,0,4,0,-4
2144,1,0,11,0,-11
2145,0,0,18,0,-18
2146,1,0,143,0,-143
2147,1,0,42,0,-42
2148,1,1,904,1353,449
2149,1,1,269,1234,965
2150,1,0,103,0,-103
2151,1,1,1505,1374,-131
2152,0,0,8,0,-8
2153,1,1,49,1782,1733
2154,0,0,30,0,-30
2155,0,0,6,0,-6
2156,0,0,90,0,-90
2157,1,1,782,1279,497
2158,1,0,167,0,-167
2159,0,0,46,0,-46
2160,1,0,0,0,0
2161,1,1,226,1265,1039
2162,1,1,852,1378,526
2163,1,0,6,0,-6
2164,1,0,69,0,-69
2165,0,0,65,0,-65
2166,1,1,1096,1295,199
2167,1,1,148,1981,1833
2168,0,0,13,0,-13
2169,1,0,4,0,-4
2170,0,0,47,0,-47
2171,0,0,76,0,-76
2172,0,0,44,0,-44
2173,0,0,41,0,-41
2174,1,0,45,0,-45
2175,1,1,1103,1479,376
2176,0,0,1,0,-1
2177,1,0,70,0,-70
2178,0,0,45,0,-45
2179,0,0,18,0,-18
2180,0,0,85,0,-85
2181,1,1,1246,3089,1843
2182,1,1,318,1793,1475
2183,1,0,57,0,-57
2184,1,1,478,1300,822
2185,1,1,185,1978,1793
2186,1,1,280,1201,921
2187,1,0,22,0,-22
2188,0,0,44,0,-44
2189,0,0,5,0,-5
2190,1,1,166,1373,1207
2191,1,1,232,1706,1474
2192,1,1,484,1423,939
2193,0,0,3,0,-3
2194,1,1,34,1380,1346
2195,1,0,64,0,-64
2196,0,0,7,0,-7
2197,1,0,51,0,-51
2198,0,0,181,0,-181
2199,1,1,576,1348,772
2200,0,0,11,0,-11
2201,1,1,670,1396,726
2202,1,1,1308,1502,194
2203,1,1,324,1471,1147
2204,0,0,0,0,0
2205,1,1,1234,1384,150
2206,1,0,4,0,-4
2207,0,0,79,0,-79
2208,0,0,22,0,-22
2209,0,0,36,0,-36
2210,0,0,34,0,-34
2211,1,0,75,0,-75
2212,0,0,41,0,-41
2213,0,0,80,0,-80
2214,1,1,730,1668,938
2215,1,0,105,0,-105
2216,1,0,88,0,-88
2217,1,1,490,1449,959
2218,0,0,62,0,-62
2219,1,1,1588,1504,-84
2220,1,1,681,1378,697
2221,1,1,191,1291,1100
2222,1,1,346,3526,3180
2223,1,0,18,0,-18
2224,1,0,23,0,-23
2225,1,0,71,0,-71
2226,1,0,5,0,-5
2227,0,0,61,0,-61
2228,1,0,22,0,-22
2229,1,1,301,2885,2584
2230,1,1,881,1559,678
2231,1,0,23,0,-23
2232,1,0,16,0,-16
2233,1,1,308,1391,1083
2234,1,1,444,1291,847
2235,1,0,36,0,-36
2236,1,1,1480,1330,-150
2237,1,1,67,1357,1290
2238,1,0,8,0,-8
2239,0,0,1,0,-1
2240,1,0,145,0,-145
2241,1,0,53,0,-53
2242,0,0,22,0,-22
2243,1,1,611,1606,995
2244,1,1,196,2283,2087
2245,0,0,25,0,-25
2246,1,1,218,1754,1536
2247,1,0,6,0,-6
2248,1,0,21,0,-21
2249,1,0,77,0,-77
2250,0,0,9,0,-9
2251,1,0,14,0,-14
2252,1,0,25,0,-25
2253,1,1,92,1506,1414
2254,0,0,86,0,-86
2255,0,0,31,0,-31
2256,0,0,110,0,-110
2257,1,0,53,0,-53
2258,0,0,124,0,-124
2259,0,0,206,0,-206
2260,1,1,650,1355,705
2261,1,1,617,1244,627
2262,0,0,1,0,-1
2263,1,0,74,0,-74
2264,1,1,526,1342,816
2265,0,0,2,0,-2
2266,0,0,23,0,-23
2267,0,0,19,0,-19
2268,1,0,108,0,-108
2269,0,0,17,0,-17
2270,0,0,1,0,-1
2271,1,1,160,1702,1542
2272,1,1,145,2219,2074
2273,1,1,349,1416,1067
2274,0,0,1,0,-1
2275,0,0,17,0,-17
2276,1,1,673,1753,1080
2277,1,1,101,1354,1253
2278,0,0,47,0,-47
2279,1,1,438,1839,1401
2280,1,1,129,1395,1266
2281,0,0,3,0,-3
2282,1,0,107,0,-107
2283,0,0,30,0,-30
2284,0,0,5,0,-5
2285,1,1,1471,1232,-239
2286,0,0,234,0,-234
2287,0,0,12,0,-12
2288,1,1,356,1410,1054
2289,1,0,24,0,-24
2290,1,1,156,1401,1245
2291,1,1,521,1587,1066
2292,1,0,15,0,-15
2293,0,0,35,0,-35
2294,1,1,6,3314,3308
2295,0,0,8,0,-8
2296,0,0,70,0,-70
2297,1,1,315,1810,1495
2298,0,0,19,0,-19
2299,1,1,924,1345,421
2300,1,0,39,0,-39
2301,0,0,38,0,-38
2302,0,0,59,0,-59
2303,0,0,65,0,-65
2304,0,0,125,0,-125
2305,1,1,1242,1351,109
2306,1,1,911,1856,945
2307,1,1,1157,1251,94
2308,0,0,50,0,-50
2309,0,0,128,0,-128
2310,0,0,141,0,-141
2311,1,0,4,0,-4
2312,1,0,58,0,-58
2313,1,0,73,0,-73
2314,1,1,1441,1609,168
2315,0,0,40,0,-40
2316,1,1,263,2485,2222
2317,1,0,17,0,-17
2318,1,1,261,1265,1004
2319,0,0,8,0,-8
2320,1,0,75,0,-75
2321,0,0,82,0,-82
2322,1,1,610,2996,2386
2323,0,0,15,0,-15
2324,0,0,15,0,-15
2325,1,1,74,1362,1288
2326,0,0,11,0,-11
2327,0,0,11,0,-11
2328,0,0,2,0,-2
2329,1,0,3,0,-3
2330,1,1,284,1276,992
2331,0,0,8,0,-8
2332,1,1,223,7480,7257
2333,1,0,42,0,-42
2334,0,0,69,0,-69
2335,0,0,18,0,-18
2336,0,0,66,0,-66
2337,0,0,3,0,-3
2338,0,0,61,0,-61
2339,1,1,385,1233,848
2340,1,1,1032,1292,260
2341,1,0,24,0,-24
2342,1,0,81,0,-81
2343,1,1,280,1476,1196
2344,1,0,22,0,-22
2345,1,0,13,0,-13
2346,0,0,11,0,-11
2347,0,0,20,0,-20
2348,0,0,54,0,-54
2349,1,1,62,1347,1285
2350,1,0,162,0,-162
2351,0,0,8,0,-8
2352,1,1,513,1497,984
2353,1,0,119,0,-119
2354,0,0,66,0,-66
2355,1,1,773,1231,458
2356,1,1,452,1265,813
2357,1,1,617,1339,722
2358,1,0,7,0,-7
2359,0,0,59,0,-59
2360,1,0,158,0,-158
2361,1,0,39,0,-39
2362,1,0,21,0,-21
2363,0,0,30,0,-30
2364,1,0,15,0,-15
2365,1,1,220,1207,987
2366,1,0,23,0,-23
2367,0,0,41,0,-41
2368,1,0,116,0,-116
2369,1,1,885,1279,394
2370,0,0,26,0,-26
2371,0,0,6,0,-6
2372,0,0,55,0,-55
2373,1,1,732,1299,567
2374,1,0,0,0,0
2375,1,0,52,0,-52
2376,1,0,32,0,-32
2377,0,0,10,0,-10
2378,1,1,620,1942,1322
2379,0,0,1,0,-1
2380,0,0,1,0,-1
2381,0,0,25,0,-25
2382,1,0,4,0,-4
2383,1,0,106,0,-106
2384,1,0,110,0,-110
2385,1,0,13,0,-13
2386,1,0,3,0,-3
2387,1,1,524,1265,741
2388,1,0,17,0,-17
2389,0,0,13,0,-13
2390,1,0,124,0,-124
2391,1,1,2384,1548,-836
2392,1,1,1212,1820,608
2393,1,0,155,0,-155
2394,0,0,45,0,-45
2395,1,0,18,0,-18
2396,0,0,40,0,-40
2397,0,0,51,0,-51
2398,1,1,952,1223,271
2399,1,0,12,0,-12
2400,0,0,54,0,-54
2401,1,1,271,1963,1692
2402,1,1,546,1276,730
2403,0,0,43,0,-43
2404,0,0,28,0,-28
2405,0,0,14,0,-14
2406,1,0,4,0,-4
2407,1,1,2009,1548,-461
2408,1,0,68,0,-68
2409,1,0,27,0,-27
2410,0,0,67,0,-67
2411,1,0,74,0,-74
2412,1,0,98,0,-98
2413,0,0,72,0,-72
2414,1,1,429,1352,923
2415,1,0,73,0,-73
2416,1,0,31,0,-31
2417,1,0,28,0,-28
2418,0,0,61,0,-61
2419,0,0,40,0,-40
2420,1,0,99,0,-99
2421,1,1,659,2507,1848
2422,1,0,78,0,-78
2423,1,0,39,0,-39
2424,0,0,98,0,-98
2425,0,0,3,0,-3
2426,1,1,443,1251,808
2427,1,1,478,1204,726
2428,0,0,37,0,-37
2429,1,1,613,1653,1040
2430,0,0,2,0,-2
2431,1,0,15,0,-15
2432,0,0,2,0,-2
2433,1,0,11,0,-11
2434,1,1,725,1428,703
2435,1,0,27,0,-27
2436,0,0,4,0,-4
2437,0,0,7,0,-7
2438,1,0,72,0,-72
2439,1,0,137,0,-137
2440,0,0,55,0,-55
2441,0,0,3,0,-3
2442,0,0,82,0,-82
2443,0,0,59,0,-59
2444,1,0,10,0,-10
2445,0,0,30,0,-30
2446,1,1,329,1329,1000
2447,0,0,104,0,-104
2448,0,0,82,0,-82
2449,0,0,37,0,-37
2450,1,0,21,0,-21
2451,1,1,510,1724,1214
2452,0,0,8,0,-8
2453,1,0,9,0,-9
2454,1,0,22,0,-22
2455,1,0,0,0,0
2456,1,0,32,0,-32
2457,0,0,81,0,-81
2458,1,0,29,0,-29
2459,1,1,352,1458,1106
2460,1,1,489,1314,825
2461,1,0,186,0,-186
2462,0,0,13,0,-13
2463,0,0,81,0,-81
2464,1,0,75,0,-75
2465,1,0,23,0,-23
2466,0,0,53,0,-53
2467,1,1,154,1475,1321
2468,0,0,28,0,-28
2469,0,0,46,0,-46
2470,1,0,57,0,-57
2471,1,1,1514,1303,-211
2472,0,0,19,0,-19
2473,1,0,44,0,-44
2474,1,0,184,0,-184
2475,1,0,9,0,-9
2476,0,0,31,0,-31
2477,0,0,22,0,-22
2478,1,0,287,0,-287
2479,1,0,18,0,-18
2480,1,0,6,0,-6
2481,0,0,8,0,-8
2482,1,0,51,0,-51
2483,0,0,100,0,-100
2484,0,0,125,0,-125
2485,0,0,21,0,-21
2486,1,0,15,0,-15
2487,1,0,51,0,-51
2488,1,0,52,0,-52
2489,1,1,139,1549,1410
2490,1,1,33,1548,1515
2491,0,0,51,0,-51
2492,0,0,42,0,-42
2493,1,0,3,0,-3
2494,0,0,26,0,-26
2495,1,0,13,0,-13
2496,1,0,13,0,-13
2497,1,1,286,1417,1131
2498,1,0,2,0,-2
2499,1,0,111,0,-111
2500,0,0,31,0,-31
2501,0,0,78,0,-78
2502,0,0,56,0,-56
2503,0,0,39,0,-39
2504,0,0,1,0,-1
2505,1,0,183,0,-183
2506,1,0,54,0,-54
2507,0,0,104,0,-104
2508,0,0,40,0,-40
2509,0,0,144,0,-144
2510,1,0,48,0,-48
2511,0,0,13,0,-13
2512,1,1,503,1287,784
2513,0,0,172,0,-172
2514,1,0,22,0,-22
2515,0,0,175,0,-175
2516,0,0,239,0,-239
2517,1,1,649,1207,558
2518,1,0,59,0,-59
2519,0,0,26,0,-26
2520,1,0,31,0,-31
2521,0,0,40,0,-40
2522,0,0,44,0,-44
2523,0,0,130,0,-130
2524,0,0,31,0,-31
2525,0,0,23,0,-23
2526,1,0,118,0,-118
2527,0,0,133,0,-133
2528,1,1,542,1551,1009
2529,0,0,147,0,-147
2530,1,0,2,0,-2
2531,1,1,557,1241,684
2532,1,0,25,0,-25
2533,1,0,24,0,-24
2534,1,1,536,1321,785
2535,0,0,12,0,-12
2536,0,0,18,0,-18
2537,0,0,1,0,-1
2538,0,0,65,0,-65
2539,1,0,90,0,-90
2540,1,0,29,0,-29
2541,1,0,141,0,-141
2542,1,1,1159,3039,1880
2543,1,1,176,1382,1206
2544,1,0,22,0,-22
2545,1,1,85,1461,1376
2546,0,0,43,0,-43
2547,1,0,15,0,-15
2548,0,0,187,0,-187
2549,1,1,449,1389,940
2550,1,0,8,0,-8
2551,0,0,10,0,-10
2552,1,0,177,0,-177
2553,1,1,80,1624,1544
2554,0,0,68,0,-68
2555,1,0,39,0,-39
2556,0,0,1,0,-1
2557,1,0,170,0,-170
2558,0,0,60,0,-60
2559,1,0,22,0,-22
2560,0,0,25,0,-25
2561,1,1,239,1388,1149
2562,0,0,29,0,-29
2563,0,0,11,0,-11
2564,0,0,23,0,-23
2565,1,0,125,0,-125
2566,1,0,4,0,-4
2567,1,0,100,0,-100
2568,1,1,621,1202,581
2569,1,1,75,3368,3293
2570,0,0,1,0,-1
2571,1,0,20,0,-20
2572,1,0,48,0,-48
2573,0,0,75,0,-75
2574,1,0,60,0,-60
2575,0,0,0,0,0
2576,1,0,30,0,-30
2577,0,0,74,0,-74
2578,1,1,299,1804,1505
2579,1,1,585,1420,835
2580,1,1,792,1231,439
2581,0,0,47,0,-47
2582,0,0,11,0,-11
2583,1,1,1580,2049,469
2584,1,1,126,1211,1085
2585,0,0,62,0,-62
2586,1,1,231,1699,1468
2587,1,1,420,1240,820
2588,1,1,579,1309,730
2589,0,0,75,0,-75
2590,0,0,21,0,-21
2591,1,0,35,0,-35
2592,1,1,86,1414,1328
2593,0,0,59,0,-59
2594,1,1,169,1280,1111
2595,0,0,23,0,-23
2596,0,0,133,0,-133
2597,0,0,66,0,-66
2598,1,0,20,0,-20
2599,1,0,169,0,-169
2600,1,0,22,0,-22
2601,0,0,88,0,-88
2602,1,1,998,1240,242
2603,0,0,5,0,-5
2604,1,1,395,1231,836
2605,1,1,240,1211,971
2606,0,0,20,0,-20
2607,0,0,38,0,-38
2608,1,1,115,1207,1092
2609,1,0,34,0,-34
2610,0,0,3,0,-3
2611,1,0,35,0,-35
2612,1,1,448,1622,1174
2613,0,0,70,0,-70
2614,0,0,74,0,-74
2615,1,0,1,0,-1
2616,0,0,16,0,-16
2617,0,0,1,0,-1
2618,1,0,30,0,-30
2619,0,0,37,0,-37
2620,1,0,15,0,-15
2621,0,0,93,0,-93
2622,1,1,104,1418,1314
2623,1,0,33,0,-33
2624,1,1,68,1334,1266
2625,0,0,50,0,-50
2626,1,1,1144,1855,711
2627,0,0,83,0,-83
2628,1,1,834,1791,957
2629,1,1,756,2360,1604
2630,1,1,1119,1354,235
2631,0,0,42,0,-42
2632,1,1,1203,1249,46
2633,1,0,40,0,-40
2634,1,0,9,0,-9
2635,1,0,3,0,-3
2636,0,0,18,0,-18
2637,1,1,1339,1341,2
2638,1,1,385,1248,863
2639,1,0,160,0,-160
2640,1,0,38,0,-38
2641,0,0,44,0,-44
2642,1,1,251,1237,986
2643,1,0,50,0,-50
2644,0,0,8,0,-8
2645,1,0,42,0,-42
2646,0,0,0,0,0
2647,1,0,6,0,-6
2648,0,0,37,0,-37
2649,1,0,93,0,-93
2650,1,0,5,0,-5
2651,1,0,51,0,-51
2652,0,0,35,0,-35
2653,1,1,125,1217,1092
2654,1,0,0,0,0
2655,0,0,5,0,-5
2656,1,1,2235,1795,-440
2657,0,0,116,0,-116
2658,0,0,78,0,-78
2659,1,1,431,1329,898
2660,1,0,37,0,-37
2661,1,1,36,1234,1198
2662,0,0,5,0,-5
2663,1,1,706,1449,743
2664,1,1,1162,1334,172
2665,1,0,50,0,-50
2666,0,0,72,0,-72
2667,1,1,506,1291,785
2668,1,1,407,1297,890
2669,1,0,45,0,-45
2670,1,0,60,0,-60
2671,1,1,223,2495,2272
2672,1,1,198,2088,1890
2673,1,0,20,0,-20
2674,1,1,223,1613,1390
2675,1,0,2,0,-2
2676,1,1,1745,1342,-403
2677,1,0,156,0,-156
2678,1,0,10,0,-10
2679,1,1,379,1261,882
2680,1,0,22,0,-22
2681,0,0,71,0,-71
2682,1,1,111,1201,1090
2683,0,0,35,0,-35
2684,0,0,39,0,-39
2685,0,0,95,0,-95
2686,0,0,27,0,-27
2687,1,1,89,2433,2344
2688,1,1,410,1592,1182
2689,0,0,55,0,-55
2690,1,0,24,0,-24
2691,1,1,214,2393,2179
2692,1,1,186,1287,1101
2693,0,0,53,0,-53
2694,0,0,16,0,-16
2695,1,1,48,1432,1384
2696,1,0,78,0,-78
2697,1,0,2,0,-2
2698,0,0,28,0,-28
2699,1,0,79,0,-79
2700,0,0,58,0,-58
2701,0,0,34,0,-34
2702,1,0,162,0,-162
2703,1,1,582,1840,1258
2704,0,0,80,0,-80
2705,0,0,15,0,-15
2706,1,0,18,0,-18
2707,0,0,52,0,-52
2708,0,0,110,0,-110
2709,1,0,36,0,-36
2710,1,0,12,0,-12
2711,0,0,41,0,-41
2712,1,0,201,0,-201
2713,0,0,26,0,-26
2714,1,0,12,0,-12
2715,1,1,1032,1391,359
2716,0,0,65,0,-65
2717,1,1,239,1207,968
2718,1,1,378,2005,1627
2719,1,0,91,0,-91
2720,0,0,17,0,-17
2721,0,0,74,0,-74
2722,1,0,137,0,-137
2723,1,1,190,1993,1803
2724,0,0,9,0,-9
2725,1,0,38,0,-38
2726,1,1,516,1679,1163
2727,0,0,152,0,-152
2728,1,1,281,1232,951
2729,1,0,9,0,-9
2730,1,0,75,0,-75
2731,1,0,1,0,-1
2732,1,1,182,1234,1052
2733,1,1,1830,2031,201
2734,1,0,13,0,-13
2735,0,0,15,0,-15
2736,1,0,23,0,-23
2737,1,0,132,0,-132
2738,0,0,22,0,-22
2739,1,1,435,1264,829
2740,1,0,42,0,-42
2741,0,0,140,0,-140
2742,1,1,740,1485,745
2743,1,1,205,1302,1097
2744,1,0,18,0,-18
2745,0,0,99,0,-99
2746,1,1,386,1324,938
2747,0,0,38,0,-38
2748,1,0,104,0,-104
2749,1,1,774,1271,497
2750,1,0,40,0,-40
2751,1,0,25,0,-25
2752,0,0,37,0,-37
2753,1,0,47,0,-47
2754,0,0,19,0,-19
2755,0,0,11,0,-11
2756,1,1,227,1516,1289
2757,1,1,222,2658,2436
2758,1,0,36,0,-36
2759,1,1,1120,1222,102
2760,1,1,1488,1472,-16
2761,1,1,1269,1955,686
2762,0,0,142,0,-142
2763,0,0,34,0,-34
2764,1,1,62,1453,1391
2765,1,0,4,0,-4
2766,0,0,49,0,-49
2767,0,0,41,0,-41
2768,1,0,25,0,-25
2769,0,0,296,0,-296
2770,0,0,145,0,-145
2771,1,1,811,2209,1398
2772,1,0,3,0,-3
2773,1,0,5,0,-5
2774,1,1,2049,1740,-309
2775,1,1,220,1445,1225
2776,1,0,53,0,-53
2777,1,0,45,0,-45
2778,1,1,477,1342,865
2779,0,0,9,0,-9
2780,1,0,27,0,-27
2781,1,1,439,1322,883
2782,1,1,379,1755,1376
2783,1,0,139,0,-139
2784,1,1,735,1558,823
2785,1,0,6,0,-6
2786,1,1,118,2396,2278
2787,1,1,86,1630,1544
2788,1,1,349,1647,1298
2789,1,0,10,0,-10
2790,1,1,423,1330,907
2791,0,0,166,0,-166
2792,1,1,1221,1367,146
2793,0,0,59,0,-59
2794,1,1,568,1396,828
2795,0,0,0,0,0
2796,1,0,0,0,0
2797,0,0,31,0,-31
2798,1,0,39,0,-39
2799,1,0,4,0,-4
2800,1,0,18,0,-18
2801,1,1,161,1305,1144
2802,0,0,177,0,-177
2803,1,0,16,0,-16
2804,1,1,308,1238,930
2805,0,0,8,0,-8
2806,0,0,29,0,-29
2807,1,1,402,1749,1347
2808,1,1,2504,1274,-1230
2809,0,0,27,0,-27
2810,1,1,217,1267,1050
2811,1,1,201,2804,2603
2812,1,1,103,2153,2050
2813,1,1,198,1862,1664
2814,0,0,18,0,-18
2815,0,0,95,0,-95
2816,0,0,55,0,-55
2817,0,0,13,0,-13
2818,0,0,30,0,-30
2819,1,0,41,0,-41
2820,0,0,82,0,-82
2821,0,0,29,0,-29
2822,0,0,22,0,-22
2823,1,1,357,1213,856
2824,1,1,41,1596,1555
2825,1,0,25,0,-25
2826,0,0,104,0,-104
2827,1,0,25,0,-25
2828,1,1,124,1471,1347
2829,1,1,2155,1220,-935
2830,0,0,104,0,-104
2831,1,1,313,1272,959
2832,1,1,1465,1305,-160
2833,1,1,48,1334,1286
2834,0,0,41,0,-41
2835,1,1,122,1391,1269
2836,1,1,332,1455,1123
2837,0,0,14,0,-14
2838,0,0,7,0,-7
2839,1,1,1118,1262,144
2840,0,0,23,0,-23
2841,0,0,67,0,-67
2842,0,0,84,0,-84
2843,1,0,53,0,-53
2844,1,0,41,0,-41
2845,0,0,26,0,-26
2846,1,1,669,1380,711
2847,1,1,268,1209,941
2848,1,1,365,1934,1569
2849,0,0,15,0,-15
2850,1,1,1965,1204,-761
2851,1,0,57,0,-57
2852,0,0,8,0,-8
2853,0,0,21,0,-21
2854,0,0,35,0,-35
2855,0,0,66,0,-66
2856,0,0,18,0,-18
2857,1,0,27,0,-27
2858,1,0,44,0,-44
2859,0,0,33,0,-33
2860,0,0,88,0,-88
2861,1,0,25,0,-25
2862,0,0,142,0,-142
2863,0,0,35,0,-35
2864,0,0,92,0,-92
2865,0,0,123,0,-123
2866,1,0,29,0,-29
2867,1,1,764,1725,961
2868,1,0,13,0,-13
2869,1,1,135,1379,1244
2870,1,1,347,2431,2084
2871,1,0,18,0,-18
2872,1,0,33,0,-33
2873,1,1,192,1382,1190
2874,1,1,441,1764,1323
2875,0,0,82,0,-82
2876,1,0,61,0,-61
2877,0,0,2,0,-2
2878,0,0,47,0,-47
2879,1,0,26,0,-26
2880,1,0,15,0,-15
2881,1,1,516,1303,787
2882,0,0,48,0,-48
2883,1,1,93,1571,1478
2884,1,1,671,1202,531
2885,0,0,40,0,-40
2886,0,0,127,0,-127
2887,1,0,10,0,-10
2888,0,0,41,0,-41
2889,1,0,59,0,-59
2890,1,0,25,0,-25
2891,1,1,1158,1297,139
2892,0,0,19,0,-19
2893,1,1,630,1213,583
2894,1,0,23,0,-23
2895,1,1,450,1347,897
2896,1,0,2,0,-2
2897,0,0,150,0,-150
2898,0,0,90,0,-90
2899,0,0,3,0,-3
2900,0,0,64,0,-64
2901,1,0,166,0,-166
2902,0,0,30,0,-30
2903,0,0,10,0,-10
2904,1,0,59,0,-59
2905,0,0,4,0,-4
2906,1,1,788,1525,737
2907,1,0,36,0,-36
2908,1,0,187,0,-187
2909,1,1,652,1561,909
2910,0,0,10,0,-10
2911,1,0,73,0,-73
2912,1,0,195,0,-195
2913,1,0,33,0,-33
2914,1,0,20,0,-20
2915,0,0,105,0,-105
2916,1,0,60,0,-60
2917,0,0,189,0,-189
2918,0,0,75,0,-75
2919,1,0,8,0,-8
2920,1,1,319,1251,932
2921,1,0,29,0,-29
2922,0,0,25,0,-25
2923,0,0,65,0,-65
2924,0,0,54,0,-54
2925,0,0,55,0,-55
2926,1,0,66,0,-66
2927,1,1,229,1221,992
2928,0,0,6,0,-6
2929,1,0,1,0,-1
2930,0,0,99,0,-99
2931,1,1,802,1233,431
2932,1,1,722,1900,1178
2933,0,0,115,0,-115
2934,1,0,34,0,-34
2935,1,1,589,1255,666
2936,0,0,34,0,-34
2937,1,0,100,0,-100
2938,0,0,15,0,-15
2939,1,1,1485,2696,1211
2940,0,0,97,0,-97
2941,1,1,580,2182,1602
2942,1,0,12,0,-12
2943,0,0,28,0,-28
2944,1,1,722,1555,833
2945,1,0,11,0,-11
2946,0,0,82,0,-82
2947,1,1,1431,1594,163
2948,0,0,53,0,-53
2949,1,0,127,0,-127
2950,1,1,270,1847,1577
2951,1,0,3,0,-3
2952,1,1,634,1242,608
2953,1,0,55,0,-55
2954,1,0,70,0,-70
2955,0,0,49,0,-49
2956,0,0,20,0,-20
2957,1,0,28,0,-28
2958,1,0,36,0,-36
2959,1,1,285,2034,1749
2960,1,0,11,0,-11
2961,0,0,61,0,-61
2962,0,0,3,0,-3
2963,1,1,900,2486,1586
2964,1,1,1490,1222,-268
2965,0,0,10,0,-10
2966,1,1,552,1921,1369
2967,0,0,49,0,-49
2968,1,0,9,0,-9
2969,1,0,10,0,-10
2970,1,1,656,2496,1840
2971,0,0,25,0,-25
2972,0,0,17,0,-17
2973,1,1,268,1279,1011
2974,1,0,88,0,-88
2975,1,0,78,0,-78
2976,1,0,18,0,-18
2977,1,0,16,0,-16
2978,1,1,28,1347,1319
2979,1,0,41,0,-41
2980,0,0,9,0,-9
2981,0,0,57,0,-57
2982,1,1,1369,1364,-5
2983,0,0,56,0,-56
2984,1,0,124,0,-124
2985,1,0,11,0,-11
2986,1,0,155,0,-155
2987,1,0,49,0,-49
2988,0,0,17,0,-17
2989,0,0,85,0,-85
2990,1,0,1,0,-1
2991,1,1,106,1440,1334
2992,1,0,18,0,-18
2993,1,0,23,0,-23
2994,1,1,377,1234,857
2995,1,1,228,1815,1587
2996,0,0,74,0,-74
2997,1,1,1083,1616,533
2998,0,0,6,0,-6
2999,1,1,566,1388,822
3000,1,1,128,1204,1076
3001,0,0,2,0,-2
3002,1,1,19,1668,1649
3003,0,0,118,0,-118
3004,1,0,25,0,-25
3005,1,0,41,0,-41
3006,0,0,15,0,-15
3007,1,0,62,0,-62
3008,1,0,11,0,-11
3009,1,1,327,2004,1677
3010,1,1,649,1429,780
3011,1,0,61,0,-61
3012,1,1,947,1225,278
3013,1,1,309,1259,950
3014,1,1,1377,1431,54
3015,1,0,36,0,-36
3016,0,0,11,0,-11
3017,0,0,12,0,-12
3018,1,0,68,0,-68
3019,1,1,639,1315,676
3020,1,1,593,1900,1307
3021,0,0,63,0,-63
3022,1,1,530,1351,821
3023,1,0,28,0,-28
3024,1,1,501,1480,979
3025,0,0,58,0,-58
3026,0,0,74,0,-74
3027,1,0,39,0,-39
3028,0,0,74,0,-74
3029,1,0,37,0,-37
3030,0,0,95,0,-95
3031,1,0,32,0,-32
3032,0,0,10,0,-10
3033,1,0,6,0,-6
3034,0,0,2,0,-2
3035,1,1,2207,1871,-336
3036,1,0,6,0,-6
3037,1,1,278,1231,953
3038,0,0,2,0,-2
3039,0,0,4,0,-4
3040,0,0,20,0,-20
3041,1,0,48,0,-48
3042,1,1,636,1247,611
3043,0,0,109,0,-109
3044,1,0,9,0,-9
3045,1,0,0,0,0
3046,0,0,159,0,-159
3047,1,1,133,1212,1079
3048,0,0,3,0,-3
3049,1,0,17,0,-17
3050,0,0,19,0,-19
3051,1,1,1057,1924,867
3052,1,0,45,0,-45
3053,0,0,4,0,-4
3054,0,0,83,0,-83
3055,1,0,16,0,-16
3056,0,0,45,0,-45
3057,1,0,75,0,-75
3058,1,1,168,1392,1224
3059,1,1,755,1970,1215
3060,0,0,6,0,-6
3061,0,0,2,0,-2
3062,1,0,6,0,-6
3063,1,1,366,1206,840
3064,0,0,8,0,-8
3065,0,0,32,0,-32
3066,1,1,1630,1784,154
3067,0,0,59,0,-59
3068,0,0,5,0,-5
3069,0,0,12,0,-12
3070,1,1,1008,1366,358
3071,0,0,4,0,-4
3072,0,0,97,0,-97
3073,1,0,0,0,0
3074,0,0,15,0,-15
3075,1,0,18,0,-18
3076,0,0,7,0,-7
3077,1,1,93,1233,1140
3078,0,0,38,0,-38
3079,0,0,4,0,-4
3080,0,0,144,0,-144
3081,1,1,957,1262,305
3082,0,0,14,0,-14
3083,0,0,81,0,-81
3084,0,0,3,0,-3
3085,0,0,22,0,-22
3086,0,0,9,0,-9
3087,0,0,82,0,-82
3088,1,0,78,0,-78
3089,0,0,149,0,-149
3090,0,0,32,0,-32
3091,1,0,11,0,-11
3092,0,0,45,0,-45
3093,1,0,116,0,-116
3094,0,0,5,0,-5
3095,0,0,125,0,-125
3096,1,1,509,3184,2675
3097,1,1,381,4545,4164
3098,0,0,109,0,-109
3099,1,1,271,1257,986
3100,0,0,93,0,-93
3101,0,0,20,0,-20
3102,1,0,53,0,-53
3103,0,0,69,0,-69
3104,0,0,20,0,-20
3105,0,0,76,0,-76
3106,1,1,910,1315,405
3107,0,0,30,0,-30
3108,0,0,10,0,-10
3109,0,0,22,0,-22
3110,1,1,64,1325,1261
3111,0,0,98,0,-98
3112,1,1,458,2050,1592
3113,1,0,44,0,-44
3114,1,1,1291,1213,-78
3115,0,0,8,0,-8
3116,1,1,2346,1584,-762
3117,1,1,197,1226,1029
3118,1,1,1175,2396,1221
3119,1,1,581,1284,703
3120,0,0,38,0,-38
3121,0,0,47,0,-47
3122,1,0,73,0,-73
3123,1,1,418,1287,869
3124,1,0,26,0,-26
3125,0,0,57,0,-57
3126,1,1,857,1213,356
3127,1,1,285,1378,1093
3128,0,0,26,0,-26
3129,1,1,375,1560,1185
3130,1,0,34,0,-34
3131,0,0,20,0,-20
3132,0,0,50,0,-50
3133,1,1,379,1609,1230
3134,0,0,69,0,-69
3135,0,0,94,0,-94
3136,0,0,109,0,-109
3137,0,0,34,0,-34
3138,1,0,182,0,-182
3139,1,1,151,1685,1534
3140,0,0,84,0,-84
3141,0,0,4,0,-4
3142,1,1,238,1267,1029
3143,0,0,78,0,-78
3144,1,0,178,0,-178
3145,1,1,909,1636,727
3146,0,0,48,0,-48
3147,1,1,487,1456,969
3148,0,0,2,0,-2
3149,1,1,22,1365,1343
3150,1,1,829,1263,434
3151,1,1,905,1333,428
3152,1,1,55,1935,1880
3153,1,0,7,0,-7
3154,1,1,869,1407,538
3155,1,0,7,0,-7
3156,1,0,1,0,-1
3157,0,0,76,0,-76
3158,1,0,1,0,-1
3159,1,0,80,0,-80
3160,1,0,49,0,-49
3161,0,0,55,0,-55
3162,0,0,16,0,-16
3163,1,0,5,0,-5
3164,1,0,24,0,-24
3165,0,0,31,0,-31
3166,1,0,104,0,-104
3167,0,0,10,0,-10
3168,0,0,88,0,-88
3169,0,0,113,0,-113
3170,0,0,10,0,-10
3171,1,1,210,1516,1306
3172,0,0,30,0,-30
3173,1,1,832,2691,1859
3174,1,0,36,0,-36
3175,0,0,35,0,-35
3176,1,1,312,1398,1086
3177,0,0,4,0,-4
3178,0,0,27,0,-27
3179,1,1,437,1412,975
3180,1,1,232,2044,1812
3181,1,1,16,1676,1660
3182,1,0,142,0,-142
3183,0,0,16,0,-16
3184,0,0,18,0,-18
3185,0,0,67,0,-67
3186,1,0,53,0,-53
3187,0,0,93,0,-93
3188,0,0,51,0,-51
3189,0,0,8,0,-8
3190,1,0,20,0,-20
3191,0,0,4,0,-4
3192,0,0,84,0,-84
3193,1,1,1486,1398,-88
3194,1,1,358,1611,1253
3195,1,0,89,0,-89
3196,0,0,16,0,-16
3197,0,0,159,0,-159
3198,1,1,268,2305,2037
3199,1,0,37,0,-37
3200,0,0,194,0,-194
3201,1,0,8,0,-8
3202,0,0,3,0,-3
3203,0,0,37,0,-37
3204,1,1,98,1469,1371
3205,0,0,171,0,-171
3206,0,0,95,0,-95
3207,1,1,636,1740,1104
3208,0,0,33,0,-33
3209,1,0,65,0,-65
3210,0,0,57,0,-57
3211,1,1,1052,1681,629
3212,0,0,42,0,-42
3213,1,1,1572,1319,-253
3214,1,0,37,0,-37
3215,0,0,96,0,-96
3216,1,0,96,0,-96
3217,1,1,1681,1227,-454
3218,1,0,141,0,-141
3219,1,1,889,1249,360
3220,0,0,63,0,-63
3221,1,0,6,0,-6
3222,0,0,27,0,-27
3223,0,0,107,0,-107
3224,1,1,219,2744,2525
3225,1,0,82,0,-82
3226,1,0,19,0,-19
3227,1,1,172,1259,1087
3228,0,0,12,0,-12
3229,1,0,77,0,-77
3230,1,1,64,2036,1972
3231,1,0,12,0,-12
3232,1,1,522,2021,1499
3233,1,0,88,0,-88
3234,0,0,0,0,0
3235,0,0,142,0,-142
3236,0,0,16,0,-16
3237,1,0,19,0,-19
3238,1,1,35,1426,1391
3239,0,0,27,0,-27
3240,1,0,4,0,-4
3241,0,0,131,0,-131
3242,0,0,37,0,-37
3243,0,0,100,0,-100
3244,0,0,30,0,-30
3245,1,1,128,1434,1306
3246,0,0,3,0,-3
3247,1,0,13,0,-13
3248,0,0,33,0,-33
3249,0,0,0,0,0
3250,0,0,44,0,-44
3251,0,0,62,0,-62
3252,1,0,60,0,-60
3253,0,0,25,0,-25
3254,1,1,422,1670,1248
3255,1,0,148,0,-148
3256,0,0,5,0,-5
3257,0,0,6,0,-6
3258,1,0,8,0,-8
3259,1,0,154,0,-154
3260,0,0,37,0,-37
3261,1,0,75,0,-75
3262,0,0,102,0,-102
3263,1,1,62,1882,1820
3264,1,1,685,1267,582
3265,1,0,4,0,-4
3266,1,0,42,0,-42
3267,1,0,49,0,-49
3268,0,0,16,0,-16
3269,1,1,491,2325,1834
3270,1,0,67,0,-67
3271,1,1,543,1775,1232
3272,1,0,39,0,-39
3273,1,1,344,1483,1139
3274,1,0,13,0,-13
3275,1,1,56,1355,1299
3276,1,0,56,0,-56
3277,0,0,11,0,-11
3278,1,1,178,1333,1155
3279,1,1,663,1445,782
3280,0,0,127,0,-127
3281,1,0,59,0,-59
3282,1,0,11,0,-11
3283,1,1,400,1352,952
3284,0,0,350,0,-350
3285,0,0,27,0,-27
3286,1,0,59,0,-59
3287,1,1,320,2493,2173
3288,0,0,203,0,-203
3289,1,1,23,1203,1180
3290,1,0,23,0,-23
3291,1,0,58,0,-58
3292,1,1,324,1222,898
3293,0,0,46,0,-46
3294,0,0,65,0,-65
3295,0,0,24,0,-24
3296,0,0,31,0,-31
3297,0,0,97,0,-97
3298,1,1,226,2048,1822
3299,0,0,153,0,-153
3300,0,0,183,0,-183
3301,0,0,0,0,0
3302,1,1,612,1743,1131
3303,1,1,261,1411,1150
3304,0,0,1,0,-1
3305,1,1,234,3026,2792
3306,0,0,128,0,-128
3307,1,0,17,0,-17
3308,1,1,513,1366,853
3309,1,0,189,0,-189
3310,1,1,2039,1321,-718
3311,0,0,95,0,-95
3312,1,1,336,1216,880
3313,1,1,1201,1357,156
3314,0,0,45,0,-45
3315,0,0,43,0,-43
3316,1,0,27,0,-27
3317,1,0,20,0,-20
3318,1,0,10,0,-10
3319,0,0,40,0,-40
3320,1,0,6,0,-6
3321,0,0,33,0,-33
3322,0,0,35,0,-35
3323,0,0,9,0,-9
3324,1,1,276,1259,983
3325,0,0,19,0,-19
3326,1,1,591,1521,930
3327,0,0,33,0,-33
3328,1,1,1390,2537,1147
3329,0,0,181,0,-181
3330,1,1,409,1831,1422
3331,0,0,85,0,-85
3332,0,0,3,0,-3
3333,1,0,40,0,-40
3334,1,1,2326,1802,-524
3335,1,1,241,1450,1209
3336,1,1,199,1431,1232
3337,1,1,905,1328,423
3338,0,0,17,0,-17
3339,0,0,13,0,-13
3340,0,0,58,0,-58
3341,1,0,15,0,-15
3342,1,0,14,0,-14
3343,1,0,6,0,-6
3344,1,1,125,1759,1634
3345,1,1,60,1337,1277
3346,0,0,48,0,-48
3347,1,0,62,0,-62
3348,1,0,22,0,-22
3349,1,1,631,1276,645
3350,1,1,206,1220,1014
3351,1,0,5,0,-5
3352,1,0,78,0,-78
3353,0,0,15,0,-15
3354,1,1,294,1824,1530
3355,1,1,236,1645,1409
3356,1,1,235,1833,1598
3357,1,0,25,0,-25
3358,1,1,354,1455,1101
3359,1,1,79,1627,1548
3360,0,0,55,0,-55
3361,1,0,62,0,-62
3362,0,0,50,0,-50
3363,1,0,110,0,-110
3364,1,0,10,0,-10
3365,1,0,34,0,-34
3366,0,0,72,0,-72
3367,1,0,86,0,-86
3368,0,0,77,0,-77
3369,1,1,1373,1501,128
3370,1,1,893,1269,376
3371,0,0,6,0,-6
3372,0,0,51,0,-51
3373,1,1,352,1367,1015
3374,1,1,1438,1482,44
3375,1,0,2,0,-2
3376,1,0,17,0,-17
3377,1,1,64,1632,1568
3378,1,1,748,1723,975
3379,1,0,66,0,-66
3380,1,1,242,1533,1291
3381,1,0,9,0,-9
3382,1,0,5,0,-5
3383,1,1,183,1337,1154
3384,1,0,217,0,-217
3385,1,0,107,0,-107
3386,1,0,2,0,-2
3387,0,0,1,0,-1
3388,1,1,408,1227,819
3389,1,0,49,0,-49
3390,1,1,139,1750,1611
3391,0,0,0,0,0
3392,0,0,112,0,-112
3393,1,1,89,1471,1382
3394,0,0,173,0,-173
3395,0,0,10,0,-10
3396,1,0,23,0,-23
3397,0,0,22,0,-22
3398,1,1,1309,1244,-65
3399,0,0,114,0,-114
3400,0,0,12,0,-12
3401,1,0,41,0,-41
3402,1,0,9,0,-9
3403,0,0,70,0,-70
3404,0,0,16,0,-16
3405,1,1,276,1306,1030
3406,1,1,1120,1565,445
3407,1,0,2,0,-2
3408,1,1,649,1745,1096
3409,1,0,12,0,-12
3410,0,0,48,0,-48
3411,0,0,84,0,-84
3412,1,0,23,0,-23
3413,1,0,52,0,-52
3414,1,0,44,0,-44
3415,1,0,34,0,-34
3416,0,0,0,0,0
3417,0,0,26,0,-26
3418,0,0,40,0,-40
3419,0,0,2,0,-2
3420,1,0,112,0,-112
3421,1,0,94,0,-94
3422,1,0,122,0,-122
3423,0,0,68,0,-68
3424,1,0,25,0,-25
3425,1,0,30,0,-30
3426,0,0,11,0,-11
3427,1,0,13,0,-13
3428,0,0,18,0,-18
3429,1,1,478,1216,738
3430,0,0,22,0,-22
3431,1,1,351,1286,935
3432,0,0,84,0,-84
3433,1,1,363,1260,897
3434,0,0,17,0,-17
3435,0,0,70,0,-70
3436,1,0,49,0,-49
3437,0,0,15,0,-15
3438,1,0,116,0,-116
3439,0,0,62,0,-62
3440,1,0,266,0,-266
3441,1,1,94,3643,3549
3442,1,0,34,0,-34
3443,1,1,82,1436,1354
3444,1,0,27,0,-27
3445,1,0,22,0,-22
3446,1,0,40,0,-40
3447,1,0,18,0,-18
3448,1,0,95,0,-95
3449,1,0,59,0,-59
3450,1,0,19,0,-19
3451,1,0,78,0,-78
3452,0,0,62,0,-62
3453,0,0,20,0,-20
3454,1,1,796,1202,406
3455,1,1,389,1442,1053
3456,1,1,120,1265,1145
3457,0,0,1,0,-1
3458,0,0,6,0,-6
3459,1,0,3,0,-3
3460,1,1,254,2936,2682
3461,1,1,206,1231,1025
3462,0,0,43,0,-43
3463,1,0,63,0,-63
3464,0,0,10,0,-10
3465,1,1,2648,2073,-575
3466,1,1,778,1230,452
3467,1,1,925,1408,483
3468,0,0,5,0,-5
3469,0,0,38,0,-38
3470,0,0,9,0,-9
3471,1,0,12,0,-12
3472,0,0,10,0,-10
3473,0,0,35,0,-35
3474,1,1,366,2131,1765
3475,1,0,102,0,-102
3476,1,0,3,0,-3
3477,0,0,18,0,-18
3478,0,0,65,0,-65
3479,0,0,75,0,-75
3480,0,0,107,0,-107
3481,1,0,16,0,-16
3482,1,1,1036,1493,457
3483,0,0,134,0,-134
3484,0,0,29,0,-29
3485,1,1,322,1250,928
3486,1,0,7,0,-7
3487,1,0,16,0,-16
3488,1,0,91,0,-91
3489,1,1,120,1546,1426
3490,0,0,79,0,-79
3491,1,1,204,2300,2096
3492,1,0,56,0,-56
3493,1,0,94,0,-94
3494,0,0,0,0,0
3495,1,1,172,1280,1108
3496,1,1,288,1381,1093
3497,1,1,266,1311,1045
3498,1,0,28,0,-28
3499,1,1,398,1619,1221
3500,0,0,27,0,-27
3501,0,0,57,0,-57
3502,0,0,24,0,-24
3503,1,1,2289,1572,-717
3504,1,1,241,1831,1590
3505,0,0,1,0,-1
3506,0,0,6,0,-6
3507,1,0,123,0,-123
3508,0,0,11,0,-11
3509,1,0,23,0,-23
3510,1,1,2716,1208,-1508
3511,0,0,11,0,-11
3512,1,0,47,0,-47
3513,1,1,250,2419,2169
3514,0,0,28,0,-28
3515,1,0,10,0,-10
3516,1,0,26,0,-26
3517,1,1,696,1765,1069
3518,0,0,52,0,-52
3519,1,1,242,1289,1047
3520,1,1,25,1440,1415
3521,1,1,570,1278,708
3522,0,0,10,0,-10
3523,1,1,1030,1517,487
3524,1,1,2231,1366,-865
3525,0,0,167,0,-167
3526,1,0,87,0,-87
3527,1,1,138,1571,1433
3528,0,0,18,0,-18
3529,1,0,21,0,-21
3530,1,0,134,0,-134
3531,1,0,36,0,-36
3532,1,1,2120,1474,-646
3533,1,0,37,0,-37
3534,1,0,31,0,-31
3535,1,0,4,0,-4
3536,1,0,12,0,-12
3537,0,0,20,0,-20
3538,1,1,637,1212,575
3539,1,0,14,0,-14
3540,1,1,271,1431,1160
3541,0,0,80,0,-80
3542,1,0,29,0,-29
3543,0,0,101,0,-101
3544,1,0,6,0,-6
3545,1,1,479,1430,951
3546,0,0,2,0,-2
3547,1,1,475,1609,1134
3548,0,0,32,0,-32
3549,0,0,56,0,-56
3550,1,1,23,1721,1698
3551,1,0,8,0,-8
3552,1,0,108,0,-108
3553,0,0,18,0,-18
3554,1,1,606,1266,660
3555,1,0,138,0,-138
3556,1,0,4,0,-4
3557,0,0,76,0,-76
3558,1,1,390,1330,940
3559,0,0,101,0,-101
3560,1,1,1085,1407,322
3561,1,1,637,2158,1521
3562,1,0,39,0,-39
3563,1,0,3,0,-3
3564,0,0,6,0,-6
3565,1,0,16,0,-16
3566,1,1,647,1301,654
3567,1,0,34,0,-34
3568,0,0,88,0,-88
3569,1,1,325,1501,1176
3570,1,1,773,1510,737
3571,0,0,30,0,-30
3572,0,0,3,0,-3
3573,1,1,457,1236,779
3574,1,0,9,0,-9
3575,1,1,540,1237,697
3576,1,0,35,0,-35
3577,0,0,63,0,-63
3578,1,0,11,0,-11
3579,1,1,201,1298,1097
3580,1,0,160,0,-160
3581,0,0,21,0,-21
3582,1,1,664,2557,1893
3583,1,0,2,0,-2
3584,0,0,16,0,-16
3585,1,1,663,1527,864
3586,1,1,61,1457,1396
3587,0,0,29,0,-29
3588,1,0,9,0,-9
3589,1,0,122,0,-122
3590,1,1,802,3428,2626
3591,0,0,23,0,-23
3592,1,1,371,2978,2607
3593,1,1,625,1344,719
3594,1,1,87,1339,1252
3595,1,0,79,0,-79
3596,0,0,39,0,-39
3597,1,0,86,0,-86
3598,1,1,671,1245,574
3599,0,0,29,0,-29
3600,0,0,47,0,-47
3601,1,1,495,1419,924
3602,1,1,33,1240,1207
3603,0,0,29,0,-29
3604,1,1,750,1329,579
3605,1,1,958,1224,266
3606,1,1,1843,1242,-601
3607,1,0,17,0,-17
3608,1,1,682,1286,604
3609,1,0,129,0,-129
3610,0,0,4,0,-4
3611,1,1,1633,1535,-98
3612,1,0,39,0,-39
3613,1,1,1692,1963,271
3614,0,0,28,0,-28
3615,1,0,37,0,-37
3616,1,0,16,0,-16
3617,0,0,35,0,-35
3618,0,0,42,0,-42
3619,1,0,46,0,-46
3620,1,0,36,0,-36
3621,1,0,103,0,-103
3622,1,0,40,0,-40
3623,1,0,37,0,-37
3624,1,0,1,0,-1
3625,1,0,0,0,0
3626,0,0,28,0,-28
3627,1,0,111,0,-111
3628,0,0,57,0,-57
3629,0,0,129,0,-129
3630,1,1,485,1203,718
3631,0,0,133,0,-133
3632,1,1,739,1361,622
3633,1,0,77,0,-77
3634,0,0,111,0,-111
3635,1,0,50,0,-50
3636,1,0,12,0,-12
3637,1,1,499,1365,866
3638,0,0,35,0,-35
3639,1,0,75,0,-75
3640,1,0,9,0,-9
3641,0,0,77,0,-77
3642,0,0,39,0,-39
3643,1,0,91,0,-91
3644,1,0,72,0,-72
3645,1,0,56,0,-56
3646,0,0,22,0,-22
3647,0,0,18,0,-18
3648,0,0,87,0,-87
3649,1,1,1371,1428,57
3650,0,0,10,0,-10
3651,0,0,45,0,-45
3652,1,0,28,0,-28
3653,1,1,751,1229,478
3654,0,0,54,0,-54
3655,1,1,114,1275,1161
3656,1,1,739,1678,939
3657,0,0,84,0,-84
3658,0,0,76,0,-76
3659,1,0,35,0,-35
3660,0,0,10,0,-10
3661,1,0,13,0,-13
3662,0,0,42,0,-42
3663,1,0,51,0,-51
3664,1,0,31,0,-31
3665,1,0,143,0,-143
3666,1,1,1299,1239,-60
3667,1,0,73,0,-73
3668,1,1,503,1807,1304
3669,1,0,1,0,-1
3670,0,0,85,0,-85
3671,1,0,202,0,-202
3672,0,0,31,0,-31
3673,0,0,15,0,-15
3674,1,0,70,0,-70
3675,1,0,146,0,-146
3676,0,0,3,0,-3
3677,1,1,195,1213,1018
3678,1,0,94,0,-94
3679,0,0,6,0,-6
3680,1,1,733,1301,568
3681,1,1,1190,1254,64
3682,1,0,25,0,-25
3683,1,0,113,0,-113
3684,1,0,9,0,-9
3685,1,1,1157,2142,985
3686,1,1,412,1225,813
3687,0,0,89,0,-89
3688,0,0,30,0,-30
3689,1,0,140,0,-140
3690,1,1,320,1273,953
3691,1,1,20,1590,1570
3692,1,1,121,1777,1656
3693,0,0,17,0,-17
3694,0,0,84,0,-84
3695,1,0,59,0,-59
3696,1,1,69,1278,1209
3697,1,1,686,1304,618
3698,1,1,434,1551,1117
3699,1,0,58,0,-58
3700,1,0,19,0,-19
3701,1,1,447,1375,928
3702,1,0,26,0,-26
3703,1,1,78,1604,1526
3704,0,0,52,0,-52
3705,1,0,110,0,-110
3706,0,0,28,0,-28
3707,1,0,1,0,-1
3708,0,0,94,0,-94
3709,0,0,26,0,-26
3710,1,1,661,1224,563
3711,1,1,1463,1957,494
3712,1,1,354,1486,1132
3713,1,0,163,0,-163
3714,0,0,22,0,-22
3715,1,1,1431,1271,-160
3716,1,0,18,0,-18
3717,1,1,363,1725,1362
3718,0,0,34,0,-34
3719,1,0,10,0,-10
3720,1,0,9,0,-9
3721,0,0,99,0,-99
3722,1,1,948,1285,337
3723,1,0,72,0,-72
3724,1,0,27,0,-27
3725,0,0,7,0,-7
3726,1,1,335,1469,1134
3727,0,0,14,0,-14
3728,1,0,7,0,-7
3729,1,1,385,1345,960
3730,1,0,10,0,-10
3731,0,0,19,0,-19
3732,1,0,6,0,-6
3733,1,0,8,0,-8
3734,1,1,154,1885,1731
3735,1,1,1549,1225,-324
3736,1,1,549,1268,719
3737,1,0,145,0,-145
3738,0,0,135,0,-135
3739,1,0,64,0,-64
3740,1,1,51,1356,1305
3741,1,1,125,1641,1516
3742,1,1,1937,1356,-581
3743,0,0,5,0,-5
3744,1,1,1330,1217,-113
3745,1,0,44,0,-44
3746,0,0,7,0,-7
3747,1,0,22,0,-22
3748,1,0,90,0,-90
3749,1,0,82,0,-82
3750,1,1,98,1206,1108
3751,1,0,102,0,-102
3752,1,1,56,1372,1316
3753,1,0,26,0,-26
3754,0,0,40,0,-40
3755,0,0,1,0,-1
3756,1,0,216,0,-216
3757,0,0,122,0,-122
3758,1,0,33,0,-33
3759,1,0,93,0,-93
3760,0,0,26,0,-26
3761,1,0,46,0,-46
3762,1,0,28,0,-28
3763,1,0,26,0,-26
3764,0,0,52,0,-52
3765,1,0,116,0,-116
3766,0,0,3,0,-3
3767,0,0,87,0,-87
3768,0,0,19,0,-19
3769,1,1,52,1216,1164
3770,1,1,978,1655,677
3771,1,0,58,0,-58
3772,1,0,18,0,-18
3773,1,1,1462,1636,174
3774,0,0,41,0,-41
3775,1,1,426,2070,1644
3776,1,0,126,0,-126
3777,1,1,1556,1298,-258
3778,1,0,30,0,-30
3779,0,0,40,0,-40
3780,1,0,5,0,-5
3781,0,0,38,0,-38
3782,0,0,25,0,-25
3783,1,0,0,0,0
3784,0,0,23,0,-23
3785,0,0,26,0,-26
3786,1,0,95,0,-95
3787,1,0,81,0,-81
3788,0,0,7,0,-7
3789,1,1,169,1299,1130
3790,1,1,131,2392,2261
3791,1,0,53,0,-53
3792,0,0,24,0,-24
3793,1,1,979,1491,512
3794,1,1,182,1628,1446
3795,1,1,700,1408,708
3796,0,0,11,0,-11
3797,1,1,23,2394,2371
3798,0,0,5,0,-5
3799,1,1,537,1499,962
3800,1,1,425,1287,862
3801,1,1,390,1229,839
3802,1,1,304,1467,1163
3803,0,0,30,0,-30
3804,1,1,969,1965,996
3805,1,0,32,0,-32
3806,1,1,1716,1761,45
3807,1,0,6,0,-6
3808,1,1,1586,1475,-111
3809,1,0,36,0,-36
3810,1,1,834,2488,1654
3811,0,0,21,0,-21
3812,0,0,7,0,-7
3813,0,0,26,0,-26
3814,1,1,1607,1563,-44
3815,1,1,181,1213,1032
3816,0,0,94,0,-94
3817,1,0,38,0,-38
3818,0,0,44,0,-44
3819,0,0,2,0,-2
3820,0,0,35,0,-35
3821,0,0,49,0,-49
3822,1,1,690,3236,2546
3823,0,0,18,0,-18
3824,1,1,313,1245,932
3825,0,0,6,0,-6
3826,0,0,28,0,-28
3827,1,1,636,1332,696
3828,1,1,22,1857,1835
3829,1,1,101,1410,1309
3830,0,0,66,0,-66
3831,0,0,5,0,-5
3832,1,1,1000,1309,309
3833,1,0,34,0,-34
3834,1,0,17,0,-17
3835,1,0,75,0,-75
3836,0,0,6,0,-6
3837,1,0,25,0,-25
3838,1,0,9,0,-9
3839,0,0,26,0,-26
3840,1,0,76,0,-76
3841,0,0,39,0,-39
3842,1,0,66,0,-66
3843,1,1,1360,4249,2889
3844,0,0,42,0,-42
3845,0,0,34,0,-34
3846,1,1,335,2652,2317
3847,1,1,624,1208,584
3848,0,0,21,0,-21
3849,0,0,37,0,-37
3850,0,0,113,0,-113
3851,1,0,37,0,-37
3852,0,0,71,0,-71
3853,1,1,137,2375,2238
3854,0,0,8,0,-8
3855,1,0,19,0,-19
3856,0,0,18,0,-18
3857,0,0,0,0,0
3858,1,1,272,1427,1155
3859,0,0,0,0,0
3860,1,1,729,1279,550
3861,1,0,26,0,-26
3862,0,0,4,0,-4
3863,0,0,179,0,-179
3864,1,1,1309,1272,-37
3865,1,1,132,1306,1174
3866,1,0,51,0,-51
3867,0,0,22,0,-22
3868,0,0,6,0,-6
3869,1,0,20,0,-20
3870,1,0,48,0,-48
3871,0,0,18,0,-18
3872,1,0,26,0,-26
3873,0,0,23,0,-23
3874,1,0,48,0,-48
3875,1,1,977,1230,253
3876,1,0,52,0,-52
3877,0,0,33,0,-33
3878,1,1,240,1348,1108
3879,1,1,328,1266,938
3880,1,1,287,1728,1441
3881,1,0,3,0,-3
3882,1,0,182,0,-182
3883,1,1,638,1252,614
3884,1,1,651,1396,745
3885,0,0,86,0,-86
3886,1,0,40,0,-40
3887,0,0,26,0,-26
3888,0,0,114,0,-114
3889,0,0,111,0,-111
3890,1,1,353,2001,1648
3891,0,0,179,0,-179
3892,1,0,94,0,-94
3893,0,0,21,0,-21
3894,0,0,31,0,-31
3895,1,1,510,1328,818
3896,0,0,46,0,-46
3897,1,0,9,0,-9
3898,1,1,454,1204,750
3899,1,1,2096,2527,431
3900,0,0,3,0,-3
3901,0,0,57,0,-57
3902,1,0,152,0,-152
3903,1,1,343,1219,876
3904,0,0,109,0,-109
3905,0,0,164,0,-164
3906,1,1,157,1492,1335
3907,1,1,196,1552,1356
3908,1,0,66,0,-66
3909,1,0,58,0,-58
3910,1,1,2083,1227,-856
3911,1,1,336,3473,3137
3912,0,0,22,0,-22
3913,0,0,37,0,-37
3914,1,1,1937,1351,-586
3915,1,1,376,1684,1308
3916,1,0,16,0,-16
3917,0,0,70,0,-70
3918,1,1,227,2077,1850
3919,0,0,16,0,-16
3920,1,1,669,1511,842
3921,1,0,43,0,-43
3922,0,0,2,0,-2
3923,1,0,8,0,-8
3924,0,0,41,0,-41
3925,1,0,50,0,-50
3926,0,0,1,0,-1
3927,0,0,19,0,-19
3928,1,1,1422,1374,-48
3929,0,0,88,0,-88
3930,1,1,1145,2026,881
3931,1,0,14,0,-14
3932,1,1,154,1448,1294
3933,0,0,32,0,-32
3934,0,0,80,0,-80
3935,0,0,20,0,-20
3936,0,0,36,0,-36
3937,0,0,8,0,-8
3938,1,1,206,2609,2403
3939,1,0,6,0,-6
3940,0,0,6,0,-6
3941,0,0,36,0,-36
3942,0,0,50,0,-50
3943,1,1,77,1258,1181
3944,0,0,71,0,-71
3945,1,1,490,1246,756
3946,1,0,4,0,-4
3947,0,0,30,0,-30
3948,1,1,24,1447,1423
3949,1,0,37,0,-37
3950,1,1,167,3814,3647
3951,0,0,50,0,-50
3952,0,0,20,0,-20
3953,1,1,143,1569,1426
3954,0,0,41,0,-41
3955,0,0,17,0,-17
3956,1,1,1182,1652,470
3957,1,1,367,1232,865
3958,0,0,3,0,-3
3959,0,0,59,0,-59
3960,0,0,20,0,-20
3961,0,0,104,0,-104
3962,1,1,621,2089,1468
3963,1,1,252,1310,1058
3964,0,0,15,0,-15
3965,0,0,77,0,-77
3966,0,0,20,0,-20
3967,1,0,59,0,-59
3968,1,0,17,0,-17
3969,1,0,1,0,-1
3970,1,1,97,1472,1375
3971,1,0,59,0,-59
3972,0,0,2,0,-2
3973,1,1,379,1633,1254
3974,0,0,52,0,-52
3975,0,0,12,0,-12
3976,1,0,2,0,-2
3977,1,0,117,0,-117
3978,1,1,284,1406,1122
3979,1,1,1582,1451,-131
3980,1,0,21,0,-21
3981,0,0,22,0,-22
3982,1,1,1146,1999,853
3983,1,1,267,1708,1441
3984,1,0,51,0,-51
3985,1,0,70,0,-70
3986,1,0,14,0,-14
3987,0,0,3,0,-3
3988,1,0,93,0,-93
3989,1,0,37,0,-37
3990,1,1,251,1317,1066
3991,1,1,891,1207,316
3992,1,0,15,0,-15
3993,1,0,66,0,-66
3994,1,1,2301,1432,-869
3995,0,0,236,0,-236
3996,0,0,106,0,-106
3997,1,1,951,1340,389
3998,1,0,20,0,-20
3999,0,0,225,0,-225
4000,0,0,43,0,-43
4001,0,0,156,0,-156
4002,1,1,391,1249,858
4003,1,1,343,1662,1319
4004,1,1,170,1829,1659
4005,1,0,44,0,-44
4006,1,1,170,1464,1294
4007,1,0,166,0,-166
4008,1,0,30,0,-30
4009,0,0,34,0,-34
4010,0,0,79,0,-79
4011,1,0,59,0,-59
4012,1,0,56,0,-56
4013,1,0,57,0,-57
4014,1,0,79,0,-79
4015,1,1,1276,2197,921
4016,1,0,9,0,-9
4017,1,0,143,0,-143
4018,1,0,24,0,-24
4019,1,1,1133,1938,805
4020,0,0,27,0,-27
4021,1,1,1131,1657,526
4022,0,0,76,0,-76
4023,1,0,26,0,-26
4024,1,1,226,1995,1769
4025,0,0,116,0,-116
4026,1,0,59,0,-59
4027,0,0,6,0,-6
4028,1,0,19,0,-19
4029,0,0,176,0,-176
4030,0,0,21,0,-21
4031,1,0,6,0,-6
4032,0,0,104,0,-104
4033,0,0,17,0,-17
4034,1,0,100,0,-100
4035,0,0,29,0,-29
4036,1,0,54,0,-54
4037,1,0,33,0,-33
4038,1,0,7,0,-7
4039,1,0,8,0,-8
4040,1,0,11,0,-11
4041,1,1,323,1286,963
4042,1,0,49,0,-49
4043,1,1,542,1386,844
4044,0,0,9,0,-9
4045,1,1,101,1207,1106
4046,0,0,1,0,-1
4047,1,0,4,0,-4
4048,1,1,504,1226,722
4049,1,0,0,0,0
4050,1,0,31,0,-31
4051,0,0,44,0,-44
4052,1,1,292,3490,3198
4053,1,0,61,0,-61
4054,1,1,708,1437,729
4055,1,0,50,0,-50
4056,1,1,844,1885,1041
4057,1,0,1,0,-1
4058,1,0,29,0,-29
4059,0,0,178,0,-178
4060,1,1,153,1681,1528
4061,0,0,48,0,-48
4062,0,0,54,0,-54
4063,1,1,246,1825,1579
4064,1,1,646,1796,1150
4065,1,1,1083,1235,152
4066,1,0,42,0,-42
4067,1,1,247,1864,1617
4068,1,0,57,0,-57
4069,0,0,1,0,-1
4070,0,0,76,0,-76
4071,1,1,625,1231,606
4072,1,0,1,0,-1
4073,0,0,53,0,-53
4074,1,1,1076,1440,364
4075,0,0,85,0,-85
4076,1,1,243,1486,1243
4077,0,0,5,0,-5
4078,1,0,4,0,-4
4079,1,1,166,1426,1260
4080,1,0,44,0,-44
4081,1,1,127,1238,1111
4082,1,1,153,1403,1250
4083,0,0,93,0,-93
4084,0,0,22,0,-22
4085,1,0,48,0,-48
4086,0,0,101,0,-101
4087,1,0,55,0,-55
4088,0,0,63,0,-63
4089,1,0,19,0,-19
4090,1,0,87,0,-87
4091,1,0,41,0,-41
4092,0,0,87,0,-87
4093,0,0,127,0,-127
4094,1,0,35,0,-35
4095,1,1,1088,1322,234
4096,0,0,9,0,-9
4097,0,0,71,0,-71
4098,1,0,49,0,-49
4099,1,0,21,0,-21
4100,1,1,188,1406,1218
4101,1,1,1150,3363,2213
4102,1,0,16,0,-16
4103,1,0,119,0,-119
4104,1,0,38,0,-38
4105,0,0,25,0,-25
4106,1,1,88,1510,1422
4107,0,0,76,0,-76
4108,0,0,48,0,-48
4109,1,1,588,1851,1263
4110,0,0,28,0,-28
4111,1,1,783,1629,846
4112,0,0,21,0,-21
4113,1,1,17,1218,1201
4114,0,0,20,0,-20
4115,0,0,37,0,-37
4116,1,1,2811,1715,-1096
4117,1,1,112,1572,1460
4118,1,1,368,1613,1245
4119,0,0,19,0,-19
4120,1,0,13,0,-13
4121,1,0,46,0,-46
4122,0,0,75,0,-75
4123,1,1,337,1258,921
4124,1,0,3,0,-3
4125,0,0,6,0,-6
4126,0,0,8,0,-8
4127,0,0,17,0,-17
4128,1,0,104,0,-104
4129,1,1,97,1595,1498
4130,1,0,14,0,-14
4131,0,0,60,0,-60
4132,1,0,95,0,-95
4133,0,0,5,0,-5
4134,1,0,23,0,-23
4135,0,0,34,0,-34
4136,0,0,34,0,-34
4137,0,0,78,0,-78
4138,1,0,95,0,-95
4139,1,1,566,2001,1435
4140,0,0,11,0,-11
4141,0,0,68,0,-68
4142,0,0,27,0,-27
4143,0,0,53,0,-53
4144,1,1,375,1355,980
4145,1,1,915,1252,337
4146,0,0,17,0,-17
4147,1,0,34,0,-34
4148,1,0,36,0,-36
4149,1,1,592,1236,644
4150,1,1,90,1261,1171
4151,0,0,3,0,-3
4152,0,0,80,0,-80
4153,0,0,7,0,-7
4154,0,0,78,0,-78
4155,1,1,24,1243,1219
4156,0,0,4,0,-4
4157,0,0,10,0,-10
4158,1,1,442,2182,1740
4159,0,0,5,0,-5
4160,0,0,67,0,-67
4161,1,1,114,1266,1152
4162,0,0,10,0,-10
4163,0,0,12,0,-12
4164,1,1,117,1416,1299
4165,1,0,40,0,-40
4166,1,1,334,1352,1018
4167,1,1,215,1496,1281
4168,1,1,485,1240,755
4169,1,0,58,0,-58
4170,0,0,88,0,-88
4171,0,0,34,0,-34
4172,1,0,36,0,-36
4173,1,0,121,0,-121
4174,1,1,1193,1340,147
4175,0,0,6,0,-6
4176,1,0,73,0,-73
4177,0,0,36,0,-36
4178,0,0,12,0,-12
4179,0,0,43,0,-43
4180,1,0,40,0,-40
4181,1,1,853,1275,422
4182,1,1,820,1345,525
4183,1,0,34,0,-34
4184,0,0,24,0,-24
4185,1,1,426,1541,1115
4186,0,0,2,0,-2
4187,1,1,423,1326,903
4188,1,1,294,1332,1038
4189,1,1,921,1233,312
4190,1,1,339,1390,1051
4191,1,1,1379,1323,-56
4192,1,1,271,1236,965
4193,0,0,32,0,-32
4194,0,0,38,0,-38
4195,0,0,42,0,-42
4196,0,0,8,0,-8
4197,1,1,897,1398,501
4198,0,0,132,0,-132
4199,0,0,40,0,-40
4200,0,0,71,0,-71
4201,1,0,50,0,-50
4202,0,0,47,0,-47
4203,1,1,542,1293,751
4204,0,0,24,0,-24
4205,0,0,50,0,-50
4206,1,0,54,0,-54
4207,0,0,17,0,-17
4208,0,0,21,0,-21
4209,1,0,7,0,-7
4210,1,1,1006,1238,232
4211,1,0,49,0,-49
4212,1,1,707,1255,548
4213,1,1,808,1295,487
4214,1,0,25,0,-25
4215,1,0,37,0,-37
4216,0,0,1,0,-1
4217,1,1,549,2133,1584
4218,1,0,35,0,-35
4219,1,1,532,2103,1571
4220,0,0,19,0,-19
4221,0,0,35,0,-35
4222,1,0,132,0,-132
4223,0,0,64,0,-64
4224,1,1,1822,1510,-312
4225,1,0,105,0,-105
4226,1,0,42,0,-42
4227,1,1,284,1514,1230
4228,1,0,6,0,-6
4229,0,0,72,0,-72
4230,1,0,71,0,-71
4231,0,0,7,0,-7
4232,0,0,45,0,-45
4233,1,0,14,0,-14
4234,1,1,624,2478,1854
4235,0,0,0,0,0
4236,1,0,66,0,-66
4237,1,1,217,1491,1274
4238,0,0,40,0,-40
4239,1,1,114,1464,1350
4240,1,1,49,1562,1513
4241,0,0,52,0,-52
4242,1,1,656,2051,1395
4243,0,0,44,0,-44
4244,1,0,143,0,-143
4245,1,0,32,0,-32
4246,1,0,55,0,-55
4247,0,0,31,0,-31
4248,0,0,2,0,-2
4249,1,1,41,1256,1215
4250,1,1,1232,1840,608
4251,1,1,888,1317,429
4252,1,1,1930,1722,-208
4253,1,0,218,0,-218
4254,1,1,451,1244,793
4255,0,0,63,0,-63
4256,1,1,723,1280,557
4257,0,0,162,0,-162
4258,0,0,145,0,-145
4259,0,0,12,0,-12
4260,1,1,2103,1616,-487
4261,0,0,10,0,-10
4262,1,0,52,0,-52
4263,1,0,42,0,-42
4264,0,0,99,0,-99
4265,1,1,377,1325,948
4266,0,0,107,0,-107
4267,1,1,436,2524,2088
4268,1,1,424,2825,2401
4269,0,0,115,0,-115
4270,1,0,70,0,-70
4271,0,0,24,0,-24
4272,0,0,21,0,-21
4273,0,0,57,0,-57
4274,1,1,31,1751,1720
4275,1,1,451,1541,1090
4276,1,0,1,0,-1
4277,1,1,196,2666,2470
4278,1,0,13,0,-13
4279,1,0,51,0,-51
4280,1,0,81,0,-81
4281,0,0,137,0,-137
4282,1,0,3,0,-3
4283,0,0,22,0,-22
4284,0,0,105,0,-105
4285,1,0,12,0,-12
4286,1,0,80,0,-80
4287,0,0,23,0,-23
4288,1,1,134,2674,2540
4289,0,0,190,0,-190
4290,0,0,18,0,-18
4291,1,0,67,0,-67
4292,1,1,123,1248,1125
4293,1,1,83,1201,1118
4294,0,0,156,0,-156
4295,0,0,5,0,-5
4296,0,0,61,0,-61
4297,0,0,145,0,-145
4298,1,1,628,2930,2302
4299,1,1,583,1215,632
4300,0,0,78,0,-78
4301,1,1,155,1435,1280
4302,1,1,154,1209,1055
4303,0,0,9,0,-9
4304,0,0,77,0,-77
4305,0,0,37,0,-37
4306,1,1,1092,1727,635
4307,1,0,22,0,-22
4308,1,1,955,1507,552
4309,1,0,41,0,-41
4310,0,0,73,0,-73
4311,0,0,7,0,-7
4312,1,1,848,1202,354
4313,1,1,306,1710,1404
4314,0,0,11,0,-11
4315,1,1,2105,1380,-725
4316,0,0,29,0,-29
4317,0,0,1,0,-1
4318,1,1,382,1570,1188
4319,1,1,327,3734,3407
4320,1,0,13,0,-13
4321,0,0,21,0,-21
4322,0,0,78,0,-78
4323,1,0,125,0,-125
4324,0,0,82,0,-82
4325,1,0,34,0,-34
4326,1,1,101,2135,2034
4327,0,0,37,0,-37
4328,1,0,23,0,-23
4329,1,0,17,0,-17
4330,1,1,189,1408,1219
4331,1,1,284,1725,1441
4332,0,0,0,0,0
4333,0,0,41,0,-41
4334,1,1,193,1257,1064
4335,1,0,34,0,-34
4336,0,0,28,0,-28
4337,0,0,75,0,-75
4338,1,1,650,1342,692
4339,0,0,41,0,-41
4340,0,0,22,0,-22
4341,0,0,21,0,-21
4342,1,1,315,1800,1485
4343,1,0,24,0,-24
4344,1,0,21,0,-21
4345,0,0,15,0,-15
4346,0,0,23,0,-23
4347,0,0,99,0,-99
4348,1,0,160,0,-160
4349,1,1,507,1250,743
4350,1,1,119,1589,1470
4351,1,0,53,0,-53
4352,1,0,14,0,-14
4353,1,1,637,1288,651
4354,0,0,13,0,-13
4355,1,1,1065,1209,144
4356,0,0,39,0,-39
4357,1,0,11,0,-11
4358,0,0,27,0,-27
4359,1,0,28,0,-28
4360,1,1,55,1359,1304
4361,0,0,31,0,-31
4362,0,0,4,0,-4
4363,0,0,44,0,-44
4364,1,0,85,0,-85
4365,0,0,17,0,-17
4366,0,0,31,0,-31
4367,0,0,105,0,-105
4368,0,0,2,0,-2
4369,1,0,38,0,-38
4370,1,0,88,0,-88
4371,1,1,424,1344,920
4372,0,0,66,0,-66
4373,0,0,1,0,-1
4374,1,1,1390,1417,27
4375,1,1,101,1797,1696
4376,1,0,130,0,-130
4377,1,1,29,1616,1587
4378,0,0,89,0,-89
4379,0,0,42,0,-42
4380,0,0,50,0,-50
4381,1,0,9,0,-9
4382,1,1,139,1699,1560
4383,1,1,813,1241,428
4384,0,0,22,0,-22
4385,0,0,92,0,-92
4386,1,0,16,0,-16
4387,1,1,511,1345,834
4388,1,1,548,2263,1715
4389,1,1,605,1267,662
4390,1,1,630,1590,960
4391,1,0,61,0,-61
4392,0,0,0,0,0
4393,0,0,17,0,-17
4394,0,0,63,0,-63
4395,0,0,214,0,-214
4396,0,0,34,0,-34
4397,1,1,1178,1889,711
4398,1,1,366,2095,1729
4399,1,0,39,0,-39
4400,1,1,274,1392,1118
4401,0,0,61,0,-61
4402,1,0,0,0,0
4403,1,1,402,1248,846
4404,1,1,299,2027,1728
4405,0,0,125,0,-125
4406,0,0,22,0,-22
4407,0,0,70,0,-70
4408,1,0,81,0,-81
4409,0,0,3,0,-3
4410,1,0,111,0,-111
4411,1,1,197,1773,1576
4412,1,0,9,0,-9
4413,1,1,677,1531,854
4414,1,0,5,0,-5
4415,1,1,175,1269,1094
4416,0,0,11,0,-11
4417,0,0,54,0,-54
4418,0,0,85,0,-85
4419,1,0,85,0,-85
4420,1,1,321,1436,1115
4421,1,0,63,0,-63
4422,1,1,156,1486,1330
4423,1,1,58,1434,1376
4424,1,1,551,1261,710
4425,1,1,1943,1929,-14
4426,1,0,127,0,-127
4427,1,0,20,0,-20
4428,0,0,133,0,-133
4429,1,0,0,0,0
4430,0,0,18,0,-18
4431,0,0,35,0,-35
4432,1,0,69,0,-69
4433,1,0,97,0,-97
4434,0,0,65,0,-65
4435,0,0,3,0,-3
4436,1,1,1012,2163,1151
4437,1,0,2,0,-2
4438,0,0,8,0,-8
4439,1,1,579,1235,656
4440,1,1,371,1319,948
4441,0,0,8,0,-8
4442,1,1,187,1717,1530
4443,0,0,46,0,-46
4444,1,0,106,0,-106
4445,0,0,119,0,-119
4446,0,0,10,0,-10
4447,1,1,409,1513,1104
4448,1,1,193,5330,5137
4449,1,1,546,1401,855
4450,1,1,121,1401,1280
4451,1,1,227,1584,1357
4452,1,0,22,0,-22
4453,0,0,101,0,-101
4454,1,0,44,0,-44
4455,1,0,25,0,-25
4456,0,0,137,0,-137
4457,1,1,561,1534,973
4458,1,1,1008,7589,6581
4459,1,1,113,1461,1348
4460,0,0,61,0,-61
4461,1,0,41,0,-41
4462,1,0,5,0,-5
4463,0,0,0,0,0
4464,0,0,4,0,-4
4465,1,1,1244,1323,79
4466,1,0,7,0,-7
4467,0,0,17,0,-17
4468,1,1,1303,2304,1001
4469,0,0,31,0,-31
4470,1,0,33,0,-33
4471,1,1,26,1421,1395
4472,1,1,1143,1448,305
4473,1,0,51,0,-51
4474,1,1,156,1534,1378
4475,1,0,43,0,-43
4476,1,1,78,1457,1379
4477,1,0,7,0,-7
4478,0,0,28,0,-28
4479,0,0,11,0,-11
4480,0,0,115,0,-115
4481,0,0,35,0,-35
4482,1,0,7,0,-7
4483,1,0,20,0,-20
4484,1,0,58,0,-58
4485,1,0,27,0,-27
4486,1,0,2,0,-2
4487,1,0,16,0,-16
4488,0,0,27,0,-27
4489,0,0,2,0,-2
4490,0,0,9,0,-9
4491,0,0,8,0,-8
4492,1,0,19,0,-19
4493,1,0,86,0,-86
4494,1,1,121,1836,1715
4495,1,0,64,0,-64
4496,1,1,159,1227,1068
4497,0,0,25,0,-25
4498,1,0,86,0,-86
4499,1,0,18,0,-18
4500,1,1,131,1973,1842
4501,1,0,39,0,-39
4502,0,0,93,0,-93
4503,1,0,4,0,-4
4504,1,0,21,0,-21
4505,0,0,7,0,-7
4506,1,0,105,0,-105
4507,1,1,93,1599,1506
4508,1,1,640,2869,2229
4509,1,1,405,2108,1703
4510,1,0,43,0,-43
4511,1,0,74,0,-74
4512,1,0,11,0,-11
4513,0,0,32,0,-32
4514,0,0,47,0,-47
4515,1,0,175,0,-175
4516,1,1,1099,1501,402
4517,1,0,39,0,-39
4518,0,0,66,0,-66
4519,1,0,3,0,-3
4520,1,1,439,1207,768
4521,1,0,116,0,-116
4522,0,0,129,0,-129
4523,1,0,31,0,-31
4524,0,0,3,0,-3
4525,0,0,84,0,-84
4526,1,1,35,1433,1398
4527,0,0,103,0,-103
4528,0,0,13,0,-13
4529,1,1,104,1280,1176
4530,0,0,45,0,-45
4531,0,0,37,0,-37
4532,1,1,286,1410,1124
4533,0,0,67,0,-67
4534,0,0,67,0,-67
4535,1,1,1066,1697,631
4536,1,0,3,0,-3
4537,1,0,4,0,-4
4538,1,0,9,0,-9
4539,0,0,55,0,-55
4540,0,0,101,0,-101
4541,1,0,9,0,-9
4542,0,0,56,0,-56
4543,0,0,31,0,-31
4544,1,1,584,1568,984
4545,1,1,502,1506,1004
4546,1,1,404,1446,1042
4547,1,0,25,0,-25
4548,1,1,169,1296,1127
4549,0,0,57,0,-57
4550,0,0,109,0,-109
4551,1,0,169,0,-169
4552,1,0,145,0,-145
4553,0,0,29,0,-29
4554,1,0,120,0,-120
4555,1,1,171,1329,1158
4556,1,0,7,0,-7
4557,1,1,619,1622,1003
4558,1,1,461,1217,756
4559,0,0,20,0,-20
4560,1,0,0,0,0
4561,0,0,190,0,-190
4562,1,1,550,1232,682
4563,1,0,9,0,-9
4564,0,0,2,0,-2
4565,1,0,4,0,-4
4566,1,1,1339,2455,1116
4567,0,0,3,0,-3
4568,1,0,76,0,-76
4569,1,1,375,1903,1528
4570,1,1,711,1416,705
4571,0,0,37,0,-37
4572,0,0,225,0,-225
4573,1,0,41,0,-41
4574,1,1,294,2470,2176
4575,0,0,77,0,-77
4576,1,0,36,0,-36
4577,0,0,5,0,-5
4578,0,0,40,0,-40
4579,1,0,10,0,-10
4580,1,1,961,1287,326
4581,1,1,1011,2800,1789
4582,1,1,1050,1513,463
4583,1,0,0,0,0
4584,1,0,16,0,-16
4585,0,0,18,0,-18
4586,0,0,51,0,-51
4587,0,0,138,0,-138
4588,1,1,277,1545,1268
4589,0,0,64,0,-64
4590,0,0,10,0,-10
4591,1,0,102,0,-102
4592,0,0,15,0,-15
4593,0,0,80,0,-80
4594,0,0,123,0,-123
4595,1,0,25,0,-25
4596,1,1,102,1652,1550
4597,0,0,74,0,-74
4598,0,0,32,0,-32
4599,0,0,35,0,-35
4600,1,0,33,0,-33
4601,1,0,46,0,-46
4602,1,0,99,0,-99
4603,1,0,80,0,-80
4604,0,0,0,0,0
4605,0,0,85,0,-85
4606,1,0,4,0,-4
4607,1,1,301,1496,1195
4608,1,0,24,0,-24
4609,1,1,988,1405,417
4610,0,0,12,0,-12
4611,1,0,119,0,-119
4612,0,0,5,0,-5
4613,1,1,72,1676,1604
4614,1,1,309,1668,1359
4615,1,0,19,0,-19
4616,1,1,169,1265,1096
4617,0,0,82,0,-82
4618,1,0,12,0,-12
4619,0,0,4,0,-4
4620,0,0,92,0,-92
4621,1,0,18,0,-18
4622,1,1,365,1310,945
4623,1,1,493,1241,748
4624,1,0,97,0,-97
4625,1,0,4,0,-4
4626,1,0,9,0,-9
4627,0,0,23,0,-23
4628,0,0,41,0,-41
4629,1,1,853,1450,597
4630,1,1,546,1300,754
4631,1,1,863,1356,493
4632,0,0,19,0,-19
4633,1,1,533,1699,1166
4634,1,0,76,0,-76
4635,1,1,303,1238,935
4636,1,1,510,2075,1565
4637,0,0,65,0,-65
4638,0,0,4,0,-4
4639,1,1,46,1558,1512
4640,1,1,501,1371,870
4641,1,0,155,0,-155
4642,1,0,83,0,-83
4643,0,0,79,0,-79
4644,0,0,6,0,-6
4645,0,0,6,0,-6
4646,0,0,24,0,-24
4647,1,0,31,0,-31
4648,0,0,106,0,-106
4649,1,1,495,1536,1041
4650,0,0,23,0,-23
4651,1,0,71,0,-71
4652,1,1,1771,3166,1395
4653,1,0,22,0,-22
4654,1,1,913,2380,1467
4655,0,0,69,0,-69
4656,1,1,195,1896,1701
4657,0,0,115,0,-115
4658,1,1,224,1489,1265
4659,1,0,26,0,-26
4660,1,1,785,1230,445
4661,1,1,241,1546,1305
4662,0,0,25,0,-25
4663,0,0,3,0,-3
4664,0,0,21,0,-21
4665,1,0,27,0,-27
4666,1,0,26,0,-26
4667,0,0,91,0,-91
4668,1,0,200,0,-200
4669,1,1,377,1304,927
4670,1,1,1103,1535,432
4671,1,1,3136,1989,-1147
4672,0,0,19,0,-19
4673,0,0,87,0,-87
4674,0,0,37,0,-37
4675,1,1,149,1333,1184
4676,0,0,12,0,-12
4677,1,0,18,0,-18
4678,0,0,70,0,-70
4679,0,0,91,0,-91
4680,0,0,9,0,-9
4681,1,1,1308,1290,-18
4682,0,0,0,0,0
4683,1,1,124,1393,1269
4684,1,0,52,0,-52
4685,0,0,26,0,-26
4686,0,0,41,0,-41
4687,1,0,16,0,-16
4688,1,1,76,1383,1307
4689,0,0,153,0,-153
4690,0,0,45,0,-45
4691,0,0,32,0,-32
4692,0,0,18,0,-18
4693,1,0,131,0,-131
4694,1,0,16,0,-16
4695,0,0,20,0,-20
4696,1,0,331,0,-331
4697,0,0,60,0,-60
4698,1,0,75,0,-75
4699,1,1,328,2872,2544
4700,1,0,78,0,-78
4701,1,0,0,0,0
4702,1,1,513,1267,754
4703,0,0,209,0,-209
4704,0,0,16,0,-16
4705,1,1,989,1228,239
4706,1,0,0,0,0
4707,0,0,24,0,-24
4708,1,1,1230,1232,2
4709,0,0,63,0,-63
4710,1,0,27,0,-27
4711,1,1,339,1449,1110
4712,0,0,10,0,-10
4713,0,0,88,0,-88
4714,1,0,35,0,-35
4715,1,0,51,0,-51
4716,0,0,28,0,-28
4717,0,0,15,0,-15
4718,0,0,22,0,-22
4719,0,0,74,0,-74
4720,1,1,116,1495,1379
4721,1,1,292,1409,1117
4722,0,0,16,0,-16
4723,0,0,16,0,-16
4724,1,1,130,1482,1352
4725,1,0,84,0,-84
4726,0,0,49,0,-49
4727,1,1,379,1495,1116
4728,1,1,525,1291,766
4729,0,0,11,0,-11
4730,1,1,626,1515,889
4731,0,0,17,0,-17
4732,1,0,1,0,-1
4733,0,0,145,0,-145
4734,0,0,35,0,-35
4735,0,0,6,0,-6
4736,0,0,144,0,-144
4737,0,0,64,0,-64
4738,0,0,26,0,-26
4739,1,0,63,0,-63
4740,1,1,1247,1758,511
4741,1,0,19,0,-19
4742,0,0,142,0,-142
4743,1,1,96,1391,1295
4744,1,1,583,1944,1361
4745,1,1,257,1439,1182
4746,0,0,119,0,-119
4747,1,1,5,1659,1654
4748,1,0,4,0,-4
4749,0,0,25,0,-25
4750,1,1,189,1261,1072
4751,0,0,47,0,-47
4752,1,0,43,0,-43
4753,1,0,111,0,-111
4754,1,0,40,0,-40
4755,1,1,1068,1708,640
4756,1,0,15,0,-15
4757,0,0,56,0,-56
4758,0,0,67,0,-67
4759,0,0,24,0,-24
4760,0,0,74,0,-74
4761,1,0,40,0,-40
4762,0,0,17,0,-17
4763,0,0,5,0,-5
4764,1,1,837,2143,1306
4765,1,0,36,0,-36
4766,0,0,79,0,-79
4767,1,1,903,2121,1218
4768,0,0,2,0,-2
4769,0,0,11,0,-11
4770,0,0,66,0,-66
4771,1,0,43,0,-43
4772,0,0,66,0,-66
4773,1,0,34,0,-34
4774,0,0,58,0,-58
4775,0,0,7,0,-7
4776,0,0,0,0,0
4777,0,0,61,0,-61
4778,1,1,595,1210,615
4779,1,1,326,1221,895
4780,1,1,454,1322,868
4781,0,0,44,0,-44
4782,1,0,9,0,-9
4783,0,0,89,0,-89
4784,0,0,6,0,-6
4785,0,0,26,0,-26
4786,1,0,1,0,-1
4787,1,1,704,2768,2064
4788,1,0,68,0,-68
4789,1,1,843,1448,605
4790,0,0,56,0,-56
4791,1,1,1337,1693,356
4792,1,0,108,0,-108
4793,1,0,16,0,-16
4794,1,1,25,1207,1182
4795,1,0,2,0,-2
4796,0,0,25,0,-25
4797,0,0,11,0,-11
4798,0,0,26,0,-26
4799,0,0,81,0,-81
4800,1,0,88,0,-88
4801,1,0,8,0,-8
4802,0,0,9,0,-9
4803,0,0,183,0,-183
4804,0,0,59,0,-59
4805,0,0,19,0,-19
4806,0,0,16,0,-16
4807,0,0,31,0,-31
4808,0,0,15,0,-15
4809,0,0,6,0,-6
4810,1,1,552,2323,1771
4811,1,0,193,0,-193
4812,0,0,138,0,-138
4813,1,0,3,0,-3
4814,0,0,144,0,-144
4815,0,0,35,0,-35
4816,0,0,105,0,-105
4817,1,0,103,0,-103
4818,1,0,312,0,-312
4819,1,1,181,1385,1204
4820,1,0,53,0,-53
4821,1,0,44,0,-44
4822,1,1,205,1408,1203
4823,0,0,10,0,-10
4824,0,0,34,0,-34
4825,0,0,45,0,-45
4826,1,1,1231,1388,157
4827,0,0,48,0,-48
4828,1,1,333,1560,1227
4829,1,0,0,0,0
4830,1,1,275,1344,1069
4831,1,0,12,0,-12
4832,0,0,20,0,-20
4833,0,0,87,0,-87
4834,0,0,158,0,-158
4835,0,0,19,0,-19
4836,0,0,19,0,-19
4837,0,0,91,0,-91
4838,1,1,387,1252,865
4839,0,0,21,0,-21
4840,0,0,51,0,-51
4841,0,0,51,0,-51
4842,0,0,1,0,-1
4843,1,1,609,1537,928
4844,1,1,263,1237,974
4845,0,0,91,0,-91
4846,1,0,64,0,-64
4847,1,1,1005,1711,706
4848,0,0,91,0,-91
4849,1,0,115,0,-115
4850,1,0,91,0,-91
4851,0,0,121,0,-121
4852,0,0,37,0,-37
4853,0,0,52,0,-52
4854,1,0,9,0,-9
4855,0,0,5,0,-5
4856,1,0,1,0,-1
4857,0,0,76,0,-76
4858,1,1,965,2143,1178
4859,0,0,1,0,-1
4860,1,1,621,1333,712
4861,1,0,24,0,-24
4862,1,0,34,0,-34
4863,0,0,8,0,-8
4864,0,0,53,0,-53
4865,1,0,4,0,-4
4866,1,1,51,1258,1207
4867,1,1,876,1231,355
4868,1,1,215,1211,996
4869,1,1,806,1280,474
4870,1,1,95,1783,1688
4871,1,0,27,0,-27
4872,1,1,83,1473,1390
4873,0,0,15,0,-15
4874,0,0,104,0,-104
4875,1,0,89,0,-89
4876,1,1,124,1503,1379
4877,1,1,205,1464,1259
4878,0,0,27,0,-27
4879,0,0,172,0,-172
4880,0,0,20,0,-20
4881,1,1,112,1852,1740
4882,1,0,0,0,0
4883,0,0,67,0,-67
4884,1,0,27,0,-27
4885,1,0,7,0,-7
4886,0,0,19,0,-19
4887,1,0,20,0,-20
4888,1,1,345,1225,880
4889,0,0,119,0,-119
4890,0,0,30,0,-30
4891,1,0,10,0,-10
4892,0,0,26,0,-26
4893,1,1,635,1279,644
4894,0,0,103,0,-103
4895,0,0,25,0,-25
4896,0,0,116,0,-116
4897,0,0,48,0,-48
4898,0,0,12,0,-12
4899,1,1,263,1490,1227
4900,0,0,28,0,-28
4901,1,1,307,1606,1299
4902,1,1,530,1268,738
4903,1,0,145,0,-145
4904,1,1,395,1260,865
4905,1,0,59,0,-59
4906,1,0,1,0,-1
4907,1,1,177,1304,1127
4908,1,1,87,1809,1722
4909,0,0,37,0,-37
4910,1,1,43,1345,1302
4911,0,0,31,0,-31
4912,0,0,16,0,-16
4913,1,1,691,1366,675
4914,0,0,54,0,-54
4915,1,1,43,1777,1734
4916,0,0,2,0,-2
4917,0,0,0,0,0
4918,1,1,107,1468,1361
4919,1,0,4,0,-4
4920,1,1,835,1219,384
4921,1,1,146,2585,2439
4922,0,0,5,0,-5
4923,1,1,916,1795,879
4924,0,0,34,0,-34
4925,1,0,5,0,-5
4926,0,0,90,0,-90
4927,1,0,13,0,-13
4928,1,0,9,0,-9
4929,0,0,58,0,-58
4930,1,0,14,0,-14
4931,1,0,44,0,-44
4932,0,0,18,0,-18
4933,0,0,11,0,-11
4934,1,1,621,1451,830
4935,0,0,28,0,-28
4936,1,0,30,0,-30
4937,0,0,86,0,-86
4938,1,0,124,0,-124
4939,1,0,78,0,-78
4940,0,0,0,0,0
4941,0,0,57,0,-57
4942,1,0,25,0,-25
4943,1,0,40,0,-40
4944,0,0,22,0,-22
4945,1,1,1211,1247,36
4946,1,0,7,0,-7
4947,1,1,1368,1204,-164
4948,1,0,62,0,-62
4949,1,1,1531,1384,-147
4950,1,1,330,1721,1391
4951,1,0,32,0,-32
4952,1,1,1274,1230,-44
4953,1,0,146,0,-146
4954,0,0,27,0,-27
4955,0,0,3,0,-3
4956,0,0,78,0,-78
4957,1,0,50,0,-50
4958,0,0,20,0,-20
4959,1,1,1491,1486,-5
4960,1,1,360,3148,2788
4961,0,0,10,0,-10
4962,0,0,63,0,-63
4963,1,1,1094,1730,636
4964,1,0,9,0,-9
4965,1,0,86,0,-86
4966,1,1,20,1359,1339
4967,1,0,28,0,-28
4968,1,1,367,1201,834
4969,1,1,1013,1251,238
4970,0,0,66,0,-66
4971,0,0,26,0,-26
4972,0,0,134,0,-134
4973,1,1,116,1858,1742
4974,1,1,317,1300,983
4975,0,0,27,0,-27
4976,0,0,59,0,-59
4977,0,0,86,0,-86
4978,1,1,145,1803,1658
4979,0,0,35,0,-35
4980,1,0,5,0,-5
4981,1,1,439,1347,908
4982,1,1,173,2429,2256
4983,1,1,60,1765,1705
4984,1,0,274,0,-274
4985,1,1,402,1526,1124
4986,1,1,49,1201,1152
4987,0,0,24,0,-24
4988,1,1,138,1751,1613
4989,1,1,53,1344,1291
4990,0,0,38,0,-38
4991,1,1,80,1610,1530
4992,0,0,48,0,-48
4993,1,0,20,0,-20
4994,1,0,98,0,-98
4995,0,0,22,0,-22
4996,1,1,476,1497,1021
4997,0,0,121,0,-121
4998,0,0,16,0,-16
4999,0,0,13,0,-13
5000,1,1,607,1266,659
5001,1,0,33,0,-33
5002,0,0,45,0,-45
5003,0,0,140,0,-140
5004,0,0,4,0,-4
5005,1,0,12,0,-12
5006,1,0,24,0,-24
5007,1,0,1,0,-1
5008,1,1,692,1417,725
5009,1,1,85,1447,1362
5010,1,1,199,1725,1526
5011,1,0,63,0,-63
5012,0,0,53,0,-53
5013,0,0,42,0,-42
5014,1,1,825,1291,466
5015,1,1,864,1260,396
5016,0,0,72,0,-72
5017,0,0,14,0,-14
5018,1,1,163,1283,1120
5019,1,0,101,0,-101
5020,0,0,27,0,-27
5021,1,1,1046,1719,673
5022,0,0,56,0,-56
5023,1,1,265,1597,1332
5024,1,0,58,0,-58
5025,1,1,38,1395,1357
5026,0,0,27,0,-27
5027,1,1,44,1230,1186
5028,1,1,2758,1217,-1541
5029,1,1,41,1519,1478
5030,0,0,17,0,-17
5031,1,1,123,1414,1291
5032,1,1,365,1614,1249
5033,0,0,12,0,-12
5034,1,1,123,1350,1227
5035,1,1,706,3184,2478
5036,0,0,24,0,-24
5037,0,0,105,0,-105
5038,0,0,7,0,-7
5039,1,1,494,1302,808
5040,1,0,66,0,-66
5041,0,0,37,0,-37
5042,0,0,70,0,-70
5043,1,1,688,1470,782
5044,1,1,1243,1682,439
5045,1,1,1245,1219,-26
5046,0,0,71,0,-71
5047,0,0,46,0,-46
5048,0,0,34,0,-34
5049,0,0,0,0,0
5050,1,0,53,0,-53
5051,0,0,22,0,-22
5052,1,1,589,3223,2634
5053,1,1,330,1214,884
5054,0,0,3,0,-3
5055,1,1,375,1667,1292
5056,1,0,137,0,-137
5057,1,0,13,0,-13
5058,0,0,58,0,-58
5059,1,0,16,0,-16
5060,0,0,90,0,-90
5061,0,0,7,0,-7
5062,1,0,69,0,-69
5063,1,1,29,1861,1832
5064,1,1,515,1243,728
5065,1,0,60,0,-60
5066,1,1,725,1300,575
5067,0,0,3,0,-3
5068,0,0,34,0,-34
5069,0,0,22,0,-22
5070,0,0,18,0,-18
5071,1,0,67,0,-67
5072,0,0,149,0,-149
5073,1,1,488,1464,976
5074,0,0,17,0,-17
5075,1,0,14,0,-14
5076,1,1,260,1351,1091
5077,0,0,14,0,-14
5078,0,0,95,0,-95
5079,0,0,1,0,-1
5080,0,0,90,0,-90
5081,1,0,9,0,-9
5082,0,0,17,0,-17
5083,0,0,250,0,-250
5084,1,0,106,0,-106
5085,1,0,31,0,-31
5086,1,1,623,1281,658
5087,1,1,473,1423,950
5088,1,1,424,1452,1028
5089,1,1,536,2008,1472
5090,0,0,84,0,-84
5091,1,0,112,0,-112
5092,0,0,15,0,-15
5093,1,1,604,1234,630
5094,0,0,54,0,-54
5095,1,1,738,1782,1044
5096,0,0,23,0,-23
5097,1,0,17,0,-17
5098,1,1,222,1361,1139
5099,1,1,339,1266,927
5100,0,0,33,0,-33
5101,1,1,846,1481,635
5102,1,1,319,1244,925
5103,1,0,29,0,-29
5104,1,1,781,2013,1232
5105,1,0,96,0,-96
5106,1,0,32,0,-32
5107,1,1,132,1993,1861
5108,0,0,7,0,-7
5109,1,0,115,0,-115
5110,1,1,68,1211,1143
5111,0,0,79,0,-79
5112,1,1,750,3562,2812
5113,0,0,27,0,-27
5114,1,1,265,1444,1179
5115,1,0,28,0,-28
5116,0,0,18,0,-18
5117,0,0,18,0,-18
5118,1,1,846,1257,411
5119,0,0,19,0,-19
5120,1,1,1414,1568,154
5121,0,0,7,0,-7
5122,1,1,249,1594,1345
5123,1,1,305,2272,1967
5124,0,0,18,0,-18
5125,1,1,950,1477,527
5126,1,1,270,1440,1170
5127,1,1,431,1438,1007
5128,0,0,2,0,-2
5129,0,0,13,0,-13
5130,0,0,219,0,-219
5131,0,0,74,0,-74
5132,0,0,153,0,-153
5133,1,0,21,0,-21
5134,1,1,929,1391,462
5135,0,0,4,0,-4
5136,0,0,8,0,-8
5137,1,0,110,0,-110
5138,1,1,77,1204,1127
5139,1,0,64,0,-64
5140,1,0,56,0,-56
5141,1,0,95,0,-95
5142,0,0,290,0,-290
5143,0,0,72,0,-72
5144,1,0,6,0,-6
5145,1,0,0,0,0
5146,1,0,196,0,-196
5147,1,1,335,1265,930
5148,0,0,11,0,-11
5149,0,0,163,0,-163
5150,0,0,59,0,-59
5151,0,0,1,0,-1
5152,0,0,137,0,-137
5153,1,1,137,2052,1915
5154,1,1,118,1252,1134
5155,1,0,176,0,-176
5156,0,0,94,0,-94
5157,0,0,12,0,-12
5158,1,0,50,0,-50
5159,1,1,319,1802,1483
5160,0,0,17,0,-17
5161,0,0,98,0,-98
5162,0,0,23,0,-23
5163,0,0,30,0,-30
5164,0,0,12,0,-12
5165,1,0,65,0,-65
5166,1,1,261,2041,1780
5167,0,0,21,0,-21
5168,0,0,14,0,-14
5169,1,1,170,1322,1152
5170,0,0,71,0,-71
5171,0,0,6,0,-6
5172,0,0,24,0,-24
5173,1,1,339,1919,1580
5174,0,0,88,0,-88
5175,0,0,96,0,-96
5176,1,0,101,0,-101
5177,0,0,3,0,-3
5178,1,0,0,0,0
5179,0,0,58,0,-58
5180,1,0,16,0,-16
5181,1,1,25,1523,1498
5182,0,0,29,0,-29
5183,1,1,118,1384,1266
5184,1,0,45,0,-45
5185,1,1,651,1858,1207
5186,1,1,265,1322,1057
5187,1,1,553,1531,978
5188,0,0,63,0,-63
5189,1,0,120,0,-120
5190,0,0,73,0,-73
5191,1,1,413,2014,1601
5192,0,0,11,0,-11
5193,0,0,35,0,-35
5194,0,0,14,0,-14
5195,1,1,781,1368,587
5196,1,1,1792,2127,335
5197,0,0,8,0,-8
5198,1,0,149,0,-149
5199,0,0,66,0,-66
5200,1,0,13,0,-13
5201,1,1,620,1852,1232
5202,1,1,231,1879,1648
5203,1,1,1374,1293,-81
5204,0,0,3,0,-3
5205,1,0,28,0,-28
5206,0,0,51,0,-51
5207,0,0,17,0,-17
5208,1,0,154,0,-154
5209,0,0,27,0,-27
5210,1,1,752,1233,481
5211,1,0,90,0,-90
5212,1,0,61,0,-61
5213,0,0,6,0,-6
5214,0,0,59,0,-59
5215,1,1,645,1457,812
5216,1,1,48,1508,1460
5217,0,0,1,0,-1
5218,1,0,18,0,-18
5219,1,0,17,0,-17
5220,0,0,3,0,-3
5221,1,1,49,1535,1486
5222,1,0,15,0,-15
5223,0,0,14,0,-14
5224,0,0,97,0,-97
5225,1,0,24,0,-24
5226,1,0,29,0,-29
5227,0,0,56,0,-56
5228,0,0,122,0,-122
5229,0,0,48,0,-48
5230,0,0,29,0,-29
5231,1,1,89,1399,1310
5232,0,0,92,0,-92
5233,1,0,4,0,-4
5234,0,0,22,0,-22
5235,1,0,52,0,-52
5236,1,0,9,0,-9
5237,1,1,18,1437,1419
5238,1,1,856,1529,673
5239,1,0,62,0,-62
5240,1,0,98,0,-98
5241,1,0,6,0,-6
5242,1,1,272,1347,1075
5243,1,0,41,0,-41
5244,0,0,61,0,-61
5245,1,0,0,0,0
5246,1,1,398,1687,1289
5247,0,0,6,0,-6
5248,0,0,9,0,-9
5249,1,0,34,0,-34
5250,1,1,280,1272,992
5251,1,1,58,1243,1185
5252,0,0,1,0,-1
5253,1,0,76,0,-76
5254,1,1,1123,2003,880
5255,1,0,11,0,-11
5256,0,0,5,0,-5
5257,1,0,93,0,-93
5258,1,1,1180,1344,164
5259,1,0,46,0,-46
5260,1,1,129,1375,1246
5261,0,0,21,0,-21
5262,1,1,184,1434,1250
5263,0,0,19,0,-19
5264,1,0,49,0,-49
5265,1,0,17,0,-17
5266,1,1,520,1525,1005
5267,0,0,14,0,-14
5268,1,1,1012,1247,235
5269,1,0,106,0,-106
5270,1,0,9,0,-9
5271,0,0,50,0,-50
5272,0,0,42,0,-42
5273,1,0,2,0,-2
5274,1,0,6,0,-6
5275,0,0,11,0,-11
5276,1,1,133,1529,1396
5277,1,1,325,1291,966
5278,1,1,175,1368,1193
5279,0,0,86,0,-86
5280,1,0,3,0,-3
5281,1,0,9,0,-9
5282,1,0,102,0,-102
5283,0,0,16,0,-16
5284,1,0,81,0,-81
5285,0,0,1,0,-1
5286,0,0,15,0,-15
5287,0,0,14,0,-14
5288,1,1,272,1300,1028
5289,1,0,94,0,-94
5290,0,0,60,0,-60
5291,0,0,38,0,-38
5292,0,0,11,0,-11
5293,1,1,55,1313,1258
5294,1,1,430,1445,1015
5295,0,0,128,0,-128
5296,1,1,1316,1603,287
5297,1,1,282,1308,1026
5298,1,0,0,0,0
5299,0,0,52,0,-52
5300,1,1,410,1400,990
5301,1,0,0,0,0
5302,1,1,1095,1591,496
5303,1,1,1810,1554,-256
5304,1,0,49,0,-49
5305,0,0,3,0,-3
5306,1,0,15,0,-15
5307,0,0,36,0,-36
5308,0,0,42,0,-42
5309,1,0,22,0,-22
5310,1,0,40,0,-40
5311,0,0,32,0,-32
5312,0,0,19,0,-19
5313,0,0,9,0,-9
5314,1,1,802,2010,1208
5315,1,0,113,0,-113
5316,0,0,92,0,-92
5317,1,0,53,0,-53
5318,0,0,13,0,-13
5319,1,0,6,0,-6
5320,0,0,36,0,-36
5321,0,0,62,0,-62
5322,1,1,71,1302,1231
5323,1,1,50,1839,1789
5324,1,1,351,1310,959
5325,0,0,77,0,-77
5326,1,1,157,1457,1300
5327,1,0,8,0,-8
5328,1,0,21,0,-21
5329,1,1,75,1502,1427
5330,0,0,148,0,-148
5331,0,0,104,0,-104
5332,0,0,5,0,-5
5333,1,1,637,1246,609
5334,1,0,8,0,-8
5335,1,0,15,0,-15
5336,0,0,12,0,-12
5337,0,0,12,0,-12
5338,1,0,61,0,-61
5339,0,0,12,0,-12
5340,1,0,123,0,-123
5341,0,0,124,0,-124
5342,1,1,274,1278,1004
5343,0,0,26,0,-26
5344,0,0,11,0,-11
5345,1,1,303,1357,1054
5346,1,0,14,0,-14
5347,1,1,123,1241,1118
5348,1,1,1174,1834,660
5349,1,1,28,1508,1480
5350,0,0,46,0,-46
5351,1,0,30,0,-30
5352,1,0,27,0,-27
5353,0,0,21,0,-21
5354,0,0,28,0,-28
5355,0,0,86,0,-86
5356,0,0,42,0,-42
5357,1,0,43,0,-43
5358,1,1,527,1588,1061
5359,1,1,282,1444,1162
5360,1,1,334,1592,1258
5361,1,1,160,1988,1828
5362,1,1,1383,1320,-63
5363,1,0,0,0,0
5364,1,1,407,1419,1012
5365,0,0,22,0,-22
5366,1,1,1057,1436,379
5367,0,0,1,0,-1
5368,1,0,181,0,-181
5369,1,0,17,0,-17
5370,1,0,21,0,-21
5371,0,0,115,0,-115
5372,1,1,577,1205,628
5373,1,0,23,0,-23
5374,0,0,12,0,-12
5375,0,0,15,0,-15
5376,1,1,1524,1283,-241
5377,0,0,112,0,-112
5378,1,0,99,0,-99
5379,1,1,254,1695,1441
5380,0,0,240,0,-240
5381,1,0,18,0,-18
5382,1,0,87,0,-87
5383,0,0,37,0,-37
5384,1,1,569,1328,759
5385,0,0,0,0,0
5386,1,1,643,1304,661
5387,1,1,169,3026,2857
5388,0,0,115,0,-115
5389,1,0,58,0,-58
5390,1,1,1282,1346,64
5391,1,0,18,0,-18
5392,1,1,202,1302,1100
5393,0,0,45,0,-45
5394,1,0,23,0,-23
5395,1,0,19,0,-19
5396,0,0,12,0,-12
5397,1,1,1528,1379,-149
5398,0,0,11,0,-11
5399,1,0,96,0,-96
5400,1,1,260,1253,993
5401,0,0,27,0,-27
5402,1,0,40,0,-40
5403,0,0,9,0,-9
5404,0,0,65,0,-65
5405,1,1,343,1251,908
5406,1,1,72,1334,1262
5407,1,1,850,1340,490
5408,0,0,108,0,-108
5409,0,0,5,0,-5
5410,0,0,138,0,-138
5411,0,0,61,0,-61
5412,0,0,152,0,-152
5413,0,0,38,0,-38
5414,1,0,8,0,-8
5415,1,1,225,1514,1289
5416,1,0,21,0,-21
5417,0,0,19,0,-19
5418,0,0,17,0,-17
5419,0,0,19,0,-19
5420,0,0,17,0,-17
5421,1,1,58,1292,1234
5422,0,0,49,0,-49
5423,1,0,80,0,-80
5424,1,0,108,0,-108
5425,1,1,12,1276,1264
5426,0,0,2,0,-2
5427,1,1,762,1316,554
5428,1,0,26,0,-26
5429,1,0,64,0,-64
5430,0,0,13,0,-13
5431,0,0,3,0,-3
5432,0,0,36,0,-36
5433,1,1,104,1424,1320
5434,0,0,42,0,-42
5435,0,0,172,0,-172
5436,1,0,47,0,-47
5437,1,1,180,1572,1392
5438,0,0,2,0,-2
5439,1,1,1554,1385,-169
5440,0,0,199,0,-199
5441,1,1,315,1421,1106
5442,1,1,98,1523,1425
5443,1,1,2584,2898,314
5444,1,1,438,1323,885
5445,1,1,66,1499,1433
5446,0,0,30,0,-30
5447,0,0,52,0,-52
5448,0,0,4,0,-4
5449,1,1,296,2797,2501
5450,1,1,152,1793,1641
5451,1,0,37,0,-37
5452,0,0,12,0,-12
5453,0,0,40,0,-40
5454,1,0,28,0,-28
5455,1,0,5,0,-5
5456,1,0,31,0,-31
5457,1,0,97,0,-97
5458,1,1,649,1660,1011
5459,1,0,15,0,-15
5460,0,0,20,0,-20
5461,0,0,75,0,-75
5462,0,0,14,0,-14
5463,0,0,76,0,-76
5464,1,1,233,1315,1082
5465,1,1,663,2912,2249
5466,0,0,2,0,-2
5467,1,1,432,1794,1362
5468,0,0,83,0,-83
5469,1,0,102,0,-102
5470,0,0,8,0,-8
5471,1,1,1388,1241,-147
5472,1,1,193,1335,1142
5473,0,0,41,0,-41
5474,0,0,17,0,-17
5475,0,0,48,0,-48
5476,1,1,447,1321,874
5477,1,0,1,0,-1
5478,0,0,78,0,-78
5479,1,1,323,1230,907
5480,0,0,41,0,-41
5481,0,0,0,0,0
5482,1,1,220,1588,1368
5483,0,0,50,0,-50
5484,1,0,6,0,-6
5485,1,0,18,0,-18
5486,1,0,13,0,-13
5487,0,0,87,0,-87
5488,1,1,36,1693,1657
5489,1,1,1024,1240,216
5490,1,0,50,0,-50
5491,1,0,179,0,-179
5492,1,0,4,0,-4
5493,0,0,141,0,-141
5494,0,0,230,0,-230
5495,0,0,13,0,-13
5496,0,0,24,0,-24
5497,1,0,2,0,-2
5498,0,0,95,0,-95
5499,1,1,701,2454,1753
5500,1,0,89,0,-89
5501,0,0,28,0,-28
5502,1,0,6,0,-6
5503,1,0,69,0,-69
5504,0,0,17,0,-17
5505,1,1,1189,1280,91
5506,1,1,205,1346,1141
5507,0,0,5,0,-5
5508,1,1,1211,1371,160
5509,0,0,1,0,-1
5510,1,0,68,0,-68
5511,1,0,3,0,-3
5512,1,1,1321,1205,-116
5513,0,0,59,0,-59
5514,0,0,27,0,-27
5515,0,0,22,0,-22
5516,1,1,400,1235,835
5517,1,0,18,0,-18
5518,0,0,158,0,-158
5519,1,0,23,0,-23
5520,1,1,351,1510,1159
5521,0,0,13,0,-13
5522,1,1,306,1280,974
5523,0,0,43,0,-43
5524,0,0,66,0,-66
5525,1,1,1889,1590,-299
5526,1,1,369,1275,906
5527,0,0,18,0,-18
5528,1,0,19,0,-19
5529,1,0,69,0,-69
5530,1,1,73,1888,1815
5531,0,0,11,0,-11
5532,0,0,67,0,-67
5533,0,0,95,0,-95
5534,0,0,40,0,-40
5535,1,1,695,1207,512
5536,0,0,2,0,-2
5537,1,1,745,2114,1369
5538,0,0,120,0,-120
5539,0,0,30,0,-30
5540,0,0,7,0,-7
5541,0,0,1,0,-1
5542,0,0,0,0,0
5543,1,0,15,0,-15
5544,0,0,7,0,-7
5545,1,1,250,1333,1083
5546,1,0,32,0,-32
5547,1,1,43,1333,1290
5548,0,0,14,0,-14
5549,0,0,63,0,-63
5550,1,0,95,0,-95
5551,1,0,68,0,-68
5552,1,0,88,0,-88
5553,1,1,191,2367,2176
5554,1,0,25,0,-25
5555,0,0,60,0,-60
5556,1,0,56,0,-56
5557,0,0,5,0,-5
5558,1,1,731,1230,499
5559,0,0,69,0,-69
5560,0,0,43,0,-43
5561,1,1,37,3258,3221
5562,1,1,323,1685,1362
5563,0,0,20,0,-20
5564,1,1,321,1251,930
5565,0,0,2,0,-2
5566,0,0,54,0,-54
5567,0,0,75,0,-75
5568,1,1,779,1496,717
5569,1,0,32,0,-32
5570,1,0,134,0,-134
5571,1,0,31,0,-31
5572,1,1,1101,2645,1544
5573,1,0,29,0,-29
5574,1,1,111,1310,1199
5575,0,0,3,0,-3
5576,1,0,93,0,-93
5577,0,0,16,0,-16
5578,0,0,36,0,-36
5579,1,1,521,1900,1379
5580,0,0,3,0,-3
5581,0,0,101,0,-101
5582,0,0,122,0,-122
5583,1,1,277,1289,1012
5584,0,0,214,0,-214
5585,1,0,15,0,-15
5586,1,0,6,0,-6
5587,1,0,7,0,-7
5588,1,0,7,0,-7
5589,0,0,29,0,-29
5590,1,0,18,0,-18
5591,0,0,10,0,-10
5592,1,1,540,1235,695
5593,0,0,56,0,-56
5594,1,0,88,0,-88
5595,1,0,114,0,-114
5596,1,0,170,0,-170
5597,0,0,42,0,-42
5598,1,1,764,1262,498
5599,1,0,44,0,-44
5600,1,1,1310,1478,168
5601,1,1,482,1911,1429
5602,1,1,316,1933,1617
5603,1,0,22,0,-22
5604,1,0,16,0,-16
5605,1,1,818,1479,661
5606,1,1,975,1339,364
5607,1,0,6,0,-6
5608,1,0,25,0,-25
5609,0,0,43,0,-43
5610,1,1,708,1728,1020
5611,1,0,15,0,-15
5612,0,0,18,0,-18
5613,0,0,85,0,-85
5614,0,0,10,0,-10
5615,1,0,16,0,-16
5616,0,0,38,0,-38
5617,1,0,85,0,-85
5618,0,0,1,0,-1
5619,1,0,62,0,-62
5620,1,0,138,0,-138
5621,0,0,39,0,-39
5622,0,0,32,0,-32
5623,1,0,40,0,-40
5624,1,0,203,0,-203
5625,0,0,35,0,-35
5626,0,0,25,0,-25
5627,1,0,20,0,-20
5628,1,0,60,0,-60
5629,1,1,3152,1351,-1801
5630,1,1,470,1310,840
5631,1,1,538,1770,1232
5632,1,1,342,1488,1146
5633,1,0,41,0,-41
5634,0,0,25,0,-25
5635,1,0,77,0,-77
5636,1,1,272,1679,1407
5637,1,1,933,1304,371
5638,1,1,392,1224,832
5639,1,0,14,0,-14
5640,1,1,2806,1901,-905
5641,0,0,81,0,-81
5642,1,0,183,0,-183
5643,0,0,4,0,-4
5644,1,0,9,0,-9
5645,1,1,204,1594,1390
5646,0,0,2,0,-2
5647,1,1,33,1459,1426
5648,0,0,39,0,-39
5649,1,1,869,2039,1170
5650,0,0,35,0,-35
5651,0,0,109,0,-109
5652,0,0,122,0,-122
5653,1,1,560,1208,648
5654,0,0,41,0,-41
5655,0,0,64,0,-64
5656,1,0,3,0,-3
5657,1,0,44,0,-44
5658,0,0,35,0,-35
5659,1,0,144,0,-144
5660,0,0,32,0,-32
5661,1,0,67,0,-67
5662,0,0,5,0,-5
5663,1,1,2312,1329,-983
5664,1,0,80,0,-80
5665,0,0,38,0,-38
5666,0,0,23,0,-23
5667,1,1,171,1338,1167
5668,0,0,3,0,-3
5669,0,0,46,0,-46
5670,0,0,10,0,-10
5671,1,0,102,0,-102
5672,1,1,1676,1716,40
5673,0,0,124,0,-124
5674,1,0,19,0,-19
5675,0,0,60,0,-60
5676,1,0,2,0,-2
5677,0,0,11,0,-11
5678,1,1,182,1245,1063
5679,1,0,13,0,-13
5680,1,0,8,0,-8
5681,0,0,36,0,-36
5682,1,1,198,1341,1143
5683,1,0,10,0,-10
5684,0,0,94,0,-94
5685,0,0,73,0,-73
5686,0,0,12,0,-12
5687,1,0,33,0,-33
5688,1,0,3,0,-3
5689,0,0,133,0,-133
5690,0,0,1,0,-1
5691,1,0,70,0,-70
5692,1,1,493,1774,1281
5693,1,0,6,0,-6
5694,1,0,12,0,-12
5695,0,0,179,0,-179
5696,1,0,10,0,-10
5697,0,0,48,0,-48
5698,0,0,5,0,-5
5699,0,0,24,0,-24
5700,0,0,26,0,-26
5701,1,0,26,0,-26
5702,1,0,108,0,-108
5703,0,0,266,0,-266
5704,1,1,362,1604,1242
5705,0,0,9,0,-9
5706,1,1,738,2009,1271
5707,0,0,48,0,-48
5708,1,1,183,1231,1048
5709,0,0,30,0,-30
5710,1,1,803,1493,690
5711,1,0,162,0,-162
5712,0,0,31,0,-31
5713,0,0,63,0,-63
5714,1,0,3,0,-3
5715,1,0,13,0,-13
5716,1,0,212,0,-212
5717,1,0,49,0,-49
5718,1,1,583,1562,979
5719,1,0,22,0,-22
5720,0,0,7,0,-7
5721,0,0,16,0,-16
5722,0,0,27,0,-27
5723,1,1,147,1401,1254
5724,1,1,270,1446,1176
5725,0,0,5,0,-5
5726,1,1,74,1619,1545
5727,1,0,110,0,-110
5728,0,0,118,0,-118
5729,0,0,52,0,-52
5730,1,1,211,1941,1730
5731,1,0,89,0,-89
5732,1,1,391,1489,1098
5733,0,0,188,0,-188
5734,1,0,73,0,-73
5735,0,0,16,0,-16
5736,1,0,46,0,-46
5737,1,0,9,0,-9
5738,1,0,35,0,-35
5739,1,1,365,1228,863
5740,1,0,22,0,-22
5741,0,0,56,0,-56
5742,1,0,144,0,-144
5743,0,0,73,0,-73
5744,1,0,3,0,-3
5745,1,0,25,0,-25
5746,0,0,40,0,-40
5747,1,0,46,0,-46
5748,0,0,26,0,-26
5749,0,0,35,0,-35
5750,0,0,148,0,-148
5751,1,1,150,1305,1155
5752,1,1,835,1520,685
5753,1,0,0,0,0
5754,1,1,373,1300,927
5755,1,1,236,3173,2937
5756,0,0,69,0,-69
5757,0,0,93,0,-93
5758,1,0,70,0,-70
5759,1,0,47,0,-47
5760,1,0,5,0,-5
5761,0,0,11,0,-11
5762,1,1,236,1740,1504
5763,1,1,478,2146,1668
5764,1,0,3,0,-3
5765,1,0,137,0,-137
5766,0,0,12,0,-12
5767,1,1,466,1279,813
5768,1,0,18,0,-18
5769,1,0,55,0,-55
5770,1,0,45,0,-45
5771,1,0,72,0,-72
5772,0,0,37,0,-37
5773,1,0,76,0,-76
5774,1,0,42,0,-42
5775,1,0,1,0,-1
5776,0,0,117,0,-117
5777,0,0,43,0,-43
5778,0,0,21,0,-21
5779,1,0,189,0,-189
5780,0,0,52,0,-52
5781,0,0,45,0,-45
5782,1,0,131,0,-131
5783,0,0,6,0,-6
5784,0,0,138,0,-138
5785,1,1,121,1506,1385
5786,1,1,103,1412,1309
5787,0,0,20,0,-20
5788,0,0,75,0,-75
5789,1,1,1141,1880,739
5790,1,0,16,0,-16
5791,0,0,55,0,-55
5792,0,0,66,0,-66
5793,1,0,27,0,-27
5794,1,0,44,0,-44
5795,1,1,614,1464,850
5796,0,0,365,0,-365
5797,1,1,803,1347,544
5798,1,1,101,1333,1232
5799,0,0,74,0,-74
5800,1,0,23,0,-23
5801,1,1,1386,1848,462
5802,1,1,1007,1492,485
5803,1,0,15,0,-15
5804,0,0,0,0,0
5805,0,0,23,0,-23
5806,1,0,16,0,-16
5807,1,0,108,0,-108
5808,1,1,653,1279,626
5809,1,1,258,2576,2318
5810,1,0,11,0,-11
5811,0,0,8,0,-8
5812,0,0,93,0,-93
5813,1,0,7,0,-7
5814,1,1,536,2119,1583
5815,1,1,91,1344,1253
5816,1,1,192,2413,2221
5817,0,0,7,0,-7
5818,0,0,40,0,-40
5819,0,0,45,0,-45
5820,1,1,835,1658,823
5821,1,1,213,1582,1369
5822,1,1,186,1224,1038
5823,1,1,361,1287,926
5824,1,1,383,1213,830
5825,1,1,190,1457,1267
5826,1,0,16,0,-16
5827,1,1,673,1201,528
5828,1,0,25,0,-25
5829,1,1,1467,1649,182
5830,1,1,74,1265,1191
5831,1,1,241,1397,1156
5832,1,0,61,0,-61
5833,1,0,101,0,-101
5834,0,0,27,0,-27
5835,0,0,14,0,-14
5836,0,0,142,0,-142
5837,1,1,475,1345,870
5838,1,1,2148,1332,-816
5839,0,0,74,0,-74
5840,1,0,124,0,-124
5841,0,0,8,0,-8
5842,0,0,159,0,-159
5843,0,0,8,0,-8
5844,1,1,77,1310,1233
5845,0,0,17,0,-17
5846,1,1,459,1493,1034
5847,1,0,15,0,-15
5848,0,0,28,0,-28
5849,0,0,1,0,-1
5850,0,0,42,0,-42
5851,0,0,0,0,0
5852,1,0,31,0,-31
5853,0,0,122,0,-122
5854,0,0,116,0,-116
5855,1,0,10,0,-10
5856,0,0,95,0,-95
5857,1,1,563,1242,679
5858,1,0,156,0,-156
5859,1,0,121,0,-121
5860,1,1,262,1238,976
5861,1,1,363,2222,1859
5862,0,0,41,0,-41
5863,1,1,1219,1327,108
5864,1,1,582,1323,741
5865,1,1,749,1391,642
5866,0,0,68,0,-68
5867,1,0,6,0,-6
5868,0,0,13,0,-13
5869,0,0,31,0,-31
5870,1,1,705,1300,595
5871,1,0,78,0,-78
5872,1,0,102,0,-102
5873,1,1,69,1843,1774
5874,0,0,7,0,-7
5875,0,0,45,0,-45
5876,0,0,2,0,-2
5877,1,1,103,1476,1373
5878,0,0,1,0,-1
5879,1,0,41,0,-41
5880,0,0,28,0,-28
5881,1,0,65,0,-65
5882,1,0,93,0,-93
5883,1,1,729,1452,723
5884,0,0,109,0,-109
5885,1,0,12,0,-12
5886,1,1,478,1320,842
5887,1,0,45,0,-45
5888,0,0,37,0,-37
5889,1,1,199,2207,2008
5890,1,1,641,1364,723
5891,1,0,14,0,-14
5892,1,0,0,0,0
5893,1,0,73,0,-73
5894,0,0,77,0,-77
5895,0,0,55,0,-55
5896,1,0,57,0,-57
5897,0,0,24,0,-24
5898,1,0,9,0,-9
5899,0,0,28,0,-28
5900,1,1,244,1287,1043
5901,0,0,74,0,-74
5902,0,0,68,0,-68
5903,1,1,164,1256,1092
5904,1,1,99,1621,1522
5905,0,0,24,0,-24
5906,1,1,1050,1956,906
5907,1,1,112,1335,1223
5908,0,0,5,0,-5
5909,1,0,7,0,-7
5910,0,0,5,0,-5
5911,1,1,386,1337,951
5912,0,0,58,0,-58
5913,0,0,15,0,-15
5914,0,0,52,0,-52
5915,1,1,165,1462,1297
5916,1,0,3,0,-3
5917,1,1,170,1362,1192
5918,1,0,3,0,-3
5919,0,0,125,0,-125
5920,0,0,94,0,-94
5921,1,1,2939,1307,-1632
5922,1,0,57,0,-57
5923,1,1,592,1418,826
5924,0,0,38,0,-38
5925,0,0,0,0,0
5926,1,1,568,1471,903
5927,1,0,2,0,-2
5928,0,0,44,0,-44
5929,1,1,473,1518,1045
5930,0,0,5,0,-5
5931,1,0,92,0,-92
5932,1,0,79,0,-79
5933,1,0,359,0,-359
5934,0,0,68,0,-68
5935,1,1,914,1461,547
5936,1,0,5,0,-5
5937,1,0,38,0,-38
5938,1,0,125,0,-125
5939,1,1,324,1263,939
5940,0,0,20,0,-20
5941,0,0,126,0,-126
5942,0,0,12,0,-12
5943,1,0,8,0,-8
5944,0,0,26,0,-26
5945,1,1,975,1237,262
5946,0,0,69,0,-69
5947,1,1,94,2213,2119
5948,1,1,302,1946,1644
5949,1,1,966,2082,1116
5950,1,1,157,1441,1284
5951,0,0,0,0,0
5952,1,0,25,0,-25
5953,1,1,86,2025,1939
5954,1,1,20,1279,1259
5955,1,0,5,0,-5
5956,0,0,15,0,-15
5957,0,0,76,0,-76
5958,1,0,62,0,-62
5959,1,1,631,1276,645
5960,1,1,928,1337,409
5961,1,0,23,0,-23
5962,1,0,273,0,-273
5963,0,0,11,0,-11
5964,0,0,31,0,-31
5965,1,0,46,0,-46
5966,1,0,77,0,-77
5967,0,0,43,0,-43
5968,0,0,32,0,-32
5969,1,1,344,1408,1064
5970,1,0,58,0,-58
5971,1,1,247,1513,1266
5972,1,0,38,0,-38
5973,1,1,124,1793,1669
5974,0,0,22,0,-22
5975,1,1,369,1637,1268
5976,1,0,11,0,-11
5977,1,1,230,1256,1026
5978,0,0,28,0,-28
5979,0,0,245,0,-245
5980,1,0,15,0,-15
5981,0,0,43,0,-43
5982,0,0,161,0,-161
5983,0,0,8,0,-8
5984,0,0,153,0,-153
5985,0,0,14,0,-14
5986,0,0,53,0,-53
5987,1,1,125,1240,1115
5988,1,1,852,1285,433
5989,1,0,108,0,-108
5990,0,0,10,0,-10
5991,1,1,182,1218,1036
5992,0,0,46,0,-46
5993,0,0,52,0,-52
5994,1,1,1581,1236,-345
5995,0,0,34,0,-34
5996,1,1,610,1615,1005
5997,0,0,148,0,-148
5998,1,1,83,2986,2903
5999,1,1,348,1424,1076
6000,1,0,23,0,-23
6001,1,0,48,0,-48
6002,0,0,47,0,-47
6003,0,0,22,0,-22
6004,1,1,442,1394,952
6005,1,1,618,1381,763
6006,1,1,383,1295,912
6007,1,1,511,1252,741
6008,1,0,115,0,-115
6009,1,0,31,0,-31
6010,0,0,59,0,-59
6011,0,0,15,0,-15
6012,1,0,6,0,-6
6013,0,0,28,0,-28
6014,1,1,1175,1379,204
6015,0,0,8,0,-8
6016,1,1,310,1741,1431
6017,1,1,286,1274,988
6018,1,0,43,0,-43
6019,1,0,23,0,-23
6020,1,1,1302,1395,93
6021,0,0,62,0,-62
6022,1,0,8,0,-8
6023,1,0,29,0,-29
6024,1,0,25,0,-25
6025,1,1,532,2435,1903
6026,1,1,177,1327,1150
6027,1,0,37,0,-37
6028,1,1,428,1598,1170
6029,0,0,20,0,-20
6030,1,0,19,0,-19
6031,1,0,84,0,-84
6032,1,0,39,0,-39
6033,1,1,286,1842,1556
6034,0,0,23,0,-23
6035,1,0,3,0,-3
6036,1,1,1122,2045,923
6037,1,0,16,0,-16
6038,1,1,508,1440,932
6039,1,0,126,0,-126
6040,1,0,74,0,-74
6041,1,1,559,1217,658
6042,0,0,64,0,-64
6043,1,0,3,0,-3
6044,1,1,216,2137,1921
6045,1,0,19,0,-19
6046,0,0,2,0,-2
6047,0,0,131,0,-131
6048,1,0,76,0,-76
6049,1,1,606,1351,745
6050,0,0,3,0,-3
6051,0,0,39,0,-39
6052,1,0,9,0,-9
6053,0,0,158,0,-158
6054,1,0,47,0,-47
6055,1,1,471,1243,772
6056,1,0,8,0,-8
6057,1,0,2,0,-2
6058,1,1,62,1413,1351
6059,0,0,69,0,-69
6060,0,0,63,0,-63
6061,0,0,30,0,-30
6062,1,0,55,0,-55
6063,0,0,25,0,-25
6064,1,1,422,2311,1889
6065,1,0,22,0,-22
6066,1,1,869,1237,368
6067,0,0,9,0,-9
6068,1,1,568,1474,906
6069,1,1,247,1391,1144
6070,1,1,383,1541,1158
6071,1,0,77,0,-77
6072,1,1,955,1239,284
6073,0,0,26,0,-26
6074,1,0,16,0,-16
6075,0,0,1,0,-1
6076,1,0,37,0,-37
6077,0,0,18,0,-18
6078,0,0,32,0,-32
6079,0,0,22,0,-22
6080,1,0,170,0,-170
6081,0,0,11,0,-11
6082,1,0,11,0,-11
6083,0,0,26,0,-26
6084,1,1,205,1253,1048
6085,0,0,82,0,-82
6086,0,0,25,0,-25
6087,1,1,340,1293,953
6088,1,0,10,0,-10
6089,1,1,488,1518,1030
6090,1,1,386,1440,1054
6091,1,1,337,1209,872
6092,1,0,159,0,-159
6093,0,0,17,0,-17
6094,1,1,629,1579,950
6095,1,0,97,0,-97
6096,1,0,4,0,-4
6097,0,0,132,0,-132
6098,0,0,51,0,-51
6099,1,0,53,0,-53
6100,0,0,43,0,-43
6101,1,1,2934,2343,-591
6102,0,0,27,0,-27
6103,1,1,70,1281,1211
6104,1,0,8,0,-8
6105,0,0,35,0,-35
6106,0,0,17,0,-17
6107,1,1,690,1299,609
6108,0,0,235,0,-235
6109,0,0,16,0,-16
6110,1,1,889,2506,1617
6111,0,0,64,0,-64
6112,0,0,78,0,-78
6113,0,0,0,0,0
6114,1,1,103,1855,1752
6115,0,0,54,0,-54
6116,1,1,300,1626,1326
6117,0,0,78,0,-78
6118,0,0,47,0,-47
6119,0,0,129,0,-129
6120,0,0,104,0,-104
6121,1,1,26,1347,1321
6122,0,0,12,0,-12
6123,1,1,1559,1601,42
6124,1,0,0,0,0
6125,0,0,0,0,0
6126,1,1,1792,1429,-363
6127,0,0,50,0,-50
6128,0,0,34,0,-34
6129,1,0,148,0,-148
6130,1,0,101,0,-101
6131,1,0,23,0,-23
6132,1,1,45,7523,7478
6133,1,1,477,1392,915
6134,0,0,9,0,-9
6135,1,1,1007,1331,324
6136,0,0,63,0,-63
6137,0,0,8,0,-8
6138,0,0,72,0,-72
6139,1,0,1,0,-1
6140,1,1,581,1337,756
6141,1,1,990,1309,319
6142,0,0,49,0,-49
6143,1,1,203,1754,1551
6144,1,1,1029,1411,382
6145,0,0,44,0,-44
6146,1,1,834,1209,375
6147,1,1,757,1700,943
6148,0,0,36,0,-36
6149,1,0,109,0,-109
6150,0,0,35,0,-35
6151,1,0,15,0,-15
6152,0,0,8,0,-8
6153,1,1,996,2571,1575
6154,1,1,202,1235,1033
6155,0,0,31,0,-31
6156,1,0,43,0,-43
6157,1,1,756,4662,3906
6158,0,0,154,0,-154
6159,0,0,15,0,-15
6160,1,1,183,1662,1479
6161,0,0,25,0,-25
6162,0,0,75,0,-75
6163,1,0,56,0,-56
6164,1,0,55,0,-55
6165,1,0,3,0,-3
6166,1,0,48,0,-48
6167,1,1,412,1435,1023
6168,0,0,18,0,-18
6169,1,0,33,0,-33
6170,1,1,1393,1254,-139
6171,1,0,33,0,-33
6172,1,1,597,1245,648
6173,0,0,12,0,-12
6174,1,1,232,1620,1388
6175,1,1,589,2127,1538
6176,0,0,43,0,-43
6177,1,0,45,0,-45
6178,1,0,6,0,-6
6179,1,1,103,1557,1454
6180,1,0,10,0,-10
6181,1,0,51,0,-51
6182,0,0,35,0,-35
6183,0,0,195,0,-195
6184,1,1,786,1364,578
6185,0,0,13,0,-13
6186,1,1,597,1553,956
6187,0,0,8,0,-8
6188,0,0,18,0,-18
6189,1,0,43,0,-43
6190,1,1,1722,1382,-340
6191,1,0,140,0,-140
6192,1,1,454,1737,1283
6193,0,0,47,0,-47
6194,1,0,29,0,-29
6195,0,0,57,0,-57
6196,1,1,382,1960,1578
6197,1,0,51,0,-51
6198,0,0,48,0,-48
6199,0,0,92,0,-92
6200,0,0,9,0,-9
6201,0,0,19,0,-19
6202,1,0,5,0,-5
6203,1,1,447,1270,823
6204,0,0,67,0,-67
6205,1,0,41,0,-41
6206,1,1,450,1260,810
6207,0,0,43,0,-43
6208,0,0,61,0,-61
6209,0,0,73,0,-73
6210,1,0,73,0,-73
6211,1,1,686,1201,515
6212,0,0,43,0,-43
6213,0,0,41,0,-41
6214,1,1,178,1259,1081
6215,1,1,378,1578,1200
6216,1,0,30,0,-30
6217,1,0,40,0,-40
6218,1,1,69,1280,1211
6219,1,0,48,0,-48
6220,1,1,316,2047,1731
6221,0,0,106,0,-106
6222,1,1,972,1313,341
6223,0,0,28,0,-28
6224,0,0,7,0,-7
6225,1,0,144,0,-144
6226,0,0,31,0,-31
6227,1,0,4,0,-4
6228,1,0,71,0,-71
6229,0,0,168,0,-168
6230,1,0,11,0,-11
6231,0,0,6,0,-6
6232,1,1,57,1550,1493
6233,1,0,19,0,-19
6234,0,0,38,0,-38
6235,1,0,117,0,-117
6236,0,0,4,0,-4
6237,0,0,10,0,-10
6238,1,1,416,1862,1446
6239,0,0,30,0,-30
6240,1,0,208,0,-208
6241,0,0,13,0,-13
6242,1,0,34,0,-34
6243,1,0,4,0,-4
6244,0,0,54,0,-54
6245,0,0,20,0,-20
6246,0,0,62,0,-62
6247,0,0,36,0,-36
6248,0,0,113,0,-113
6249,1,1,793,1987,1194
6250,1,0,131,0,-131
6251,0,0,58,0,-58
6252,1,0,88,0,-88
6253,1,1,669,2354,1685
6254,0,0,3,0,-3
6255,0,0,12,0,-12
6256,1,1,487,1649,1162
6257,0,0,15,0,-15
6258,0,0,81,0,-81
6259,1,0,13,0,-13
6260,0,0,13,0,-13
6261,0,0,20,0,-20
6262,1,1,863,1272,409
6263,1,1,203,1234,1031
6264,0,0,31,0,-31
6265,1,0,88,0,-88
6266,1,1,102,1436,1334
6267,0,0,29,0,-29
6268,0,0,23,0,-23
6269,0,0,22,0,-22
6270,1,1,1707,1301,-406
6271,1,1,15,2800,2785
6272,1,0,17,0,-17
6273,1,1,345,1206,861
6274,1,0,17,0,-17
6275,0,0,65,0,-65
6276,0,0,80,0,-80
6277,1,0,0,0,0
6278,1,1,93,1935,1842
6279,1,1,722,1416,694
6280,0,0,19,0,-19
6281,1,0,7,0,-7
6282,1,0,61,0,-61
6283,0,0,41,0,-41
6284,1,1,553,1569,1016
6285,1,0,20,0,-20
6286,0,0,7,0,-7
6287,1,0,154,0,-154
6288,1,0,1,0,-1
6289,0,0,31,0,-31
6290,1,1,284,1241,957
6291,1,0,28,0,-28
6292,1,1,560,1290,730
6293,1,1,832,1279,447
6294,1,0,6,0,-6
6295,0,0,109,0,-109
6296,1,1,642,1390,748
6297,1,1,408,1353,945
6298,1,1,678,1304,626
6299,1,1,1339,1873,534
6300,1,0,41,0,-41
6301,0,0,31,0,-31
6302,0,0,28,0,-28
6303,1,0,5,0,-5
6304,1,0,112,0,-112
6305,1,1,533,1379,846
6306,1,1,201,1309,1108
6307,0,0,71,0,-71
6308,0,0,13,0,-13
6309,1,1,783,1460,677
6310,1,0,110,0,-110
6311,0,0,40,0,-40
6312,0,0,54,0,-54
6313,1,1,924,1868,944
6314,0,0,74,0,-74
6315,1,0,61,0,-61
6316,0,0,1,0,-1
6317,1,0,56,0,-56
6318,0,0,4,0,-4
6319,1,0,7,0,-7
6320,1,1,361,1299,938
6321,1,0,6,0,-6
6322,1,0,118,0,-118
6323,0,0,18,0,-18
6324,1,0,167,0,-167
6325,0,0,64,0,-64
6326,0,0,32,0,-32
6327,1,1,502,1295,793
6328,1,1,94,1358,1264
6329,1,1,593,1255,662
6330,0,0,1,0,-1
6331,1,0,11,0,-11
6332,0,0,74,0,-74
6333,1,1,542,1463,921
6334,1,1,473,1272,799
6335,0,0,51,0,-51
6336,0,0,138,0,-138
6337,1,0,37,0,-37
6338,1,1,248,1813,1565
6339,1,1,1346,1964,618
6340,1,1,2013,1265,-748
6341,0,0,5,0,-5
6342,1,0,14,0,-14
6343,1,1,330,1232,902
6344,0,0,19,0,-19
6345,1,1,391,1231,840
6346,1,1,535,1898,1363
6347,0,0,26,0,-26
6348,0,0,34,0,-34
6349,0,0,18,0,-18
6350,0,0,36,0,-36
6351,1,0,71,0,-71
6352,1,1,540,1474,934
6353,1,1,221,1892,1671
6354,1,1,396,1855,1459
6355,1,0,36,0,-36
6356,1,1,1223,1374,151
6357,1,1,203,1345,1142
6358,0,0,29,0,-29
6359,0,0,4,0,-4
6360,1,0,146,0,-146
6361,1,1,741,1909,1168
6362,1,0,13,0,-13
6363,1,0,155,0,-155
6364,1,1,158,2001,1843
6365,1,1,882,1221,339
6366,1,0,45,0,-45
6367,0,0,25,0,-25
6368,0,0,0,0,0
6369,1,1,80,1669,1589
6370,1,0,49,0,-49
6371,1,1,137,1502,1365
6372,1,0,82,0,-82
6373,1,0,32,0,-32
6374,1,1,576,1566,990
6375,1,1,478,1203,725
6376,0,0,92,0,-92
6377,1,1,224,3383,3159
6378,1,1,160,1527,1367
6379,1,1,379,1447,1068
6380,1,0,19,0,-19
6381,0,0,44,0,-44
6382,1,1,486,1399,913
6383,1,1,2221,2343,122
6384,0,0,27,0,-27
6385,0,0,177,0,-177
6386,1,0,35,0,-35
6387,0,0,34,0,-34
6388,0,0,246,0,-246
6389,1,0,51,0,-51
6390,1,1,67,1761,1694
6391,0,0,72,0,-72
6392,1,1,440,2065,1625
6393,0,0,125,0,-125
6394,0,0,8,0,-8
6395,1,1,2910,1960,-950
6396,1,0,36,0,-36
6397,0,0,22,0,-22
6398,1,1,167,1530,1363
6399,0,0,55,0,-55
6400,0,0,21,0,-21
6401,0,0,143,0,-143
6402,1,0,44,0,-44
6403,1,1,299,1439,1140
6404,1,0,14,0,-14
6405,1,1,235,1341,1106
6406,0,0,27,0,-27
6407,1,1,960,1407,447
6408,1,1,273,1789,1516
6409,1,1,1278,1234,-44
6410,0,0,13,0,-13
6411,0,0,57,0,-57
6412,1,0,142,0,-142
6413,1,0,39,0,-39
6414,0,0,11,0,-11
6415,1,0,6,0,-6
6416,1,0,137,0,-137
6417,1,0,82,0,-82
6418,0,0,4,0,-4
6419,0,0,13,0,-13
6420,0,0,109,0,-109
6421,1,1,343,1214,871
6422,1,1,126,1445,1319
6423,1,0,40,0,-40
6424,0,0,39,0,-39
6425,1,0,10,0,-10
6426,1,0,9,0,-9
6427,0,0,6,0,-6
6428,1,0,100,0,-100
6429,0,0,88,0,-88
6430,1,1,755,1265,510
6431,1,1,424,2003,1579
6432,0,0,17,0,-17
6433,1,0,127,0,-127
6434,0,0,120,0,-120
6435,0,0,14,0,-14
6436,0,0,234,0,-234
6437,0,0,8,0,-8
6438,0,0,43,0,-43
6439,1,1,634,1236,602
6440,0,0,5,0,-5
6441,0,0,13,0,-13
6442,1,1,336,1496,1160
6443,1,1,661,1337,676
6444,1,1,1244,1534,290
6445,0,0,98,0,-98
6446,1,0,13,0,-13
6447,0,0,36,0,-36
6448,0,0,22,0,-22
6449,0,0,131,0,-131
6450,1,0,14,0,-14
6451,0,0,19,0,-19
6452,1,1,704,2525,1821
6453,1,0,4,0,-4
6454,1,1,141,1272,1131
6455,1,1,1151,1311,160
6456,1,0,11,0,-11
6457,1,1,1194,1278,84
6458,1,0,53,0,-53
6459,0,0,57,0,-57
6460,1,1,143,1288,1145
6461,1,0,48,0,-48
6462,1,0,18,0,-18
6463,1,0,34,0,-34
6464,0,0,147,0,-147
6465,1,1,403,1223,820
6466,1,0,118,0,-118
6467,1,0,50,0,-50
6468,1,1,899,1208,309
6469,0,0,71,0,-71
6470,0,0,18,0,-18
6471,1,0,7,0,-7
6472,1,0,34,0,-34
6473,1,1,368,1777,1409
6474,1,0,7,0,-7
6475,0,0,105,0,-105
6476,0,0,47,0,-47
6477,0,0,157,0,-157
6478,1,0,82,0,-82
6479,1,0,39,0,-39
6480,0,0,45,0,-45
6481,1,0,74,0,-74
6482,1,0,8,0,-8
6483,0,0,4,0,-4
6484,1,0,13,0,-13
6485,0,0,296,0,-296
6486,1,1,217,2083,1866
6487,1,0,18,0,-18
6488,1,0,15,0,-15
6489,1,1,235,1560,1325
6490,0,0,63,0,-63
6491,1,0,14,0,-14
6492,0,0,36,0,-36
6493,0,0,63,0,-63
6494,0,0,73,0,-73
6495,0,0,78,0,-78
6496,1,0,24,0,-24
6497,1,1,68,5215,5147
6498,0,0,198,0,-198
6499,1,0,16,0,-16
6500,1,0,11,0,-11
6501,1,1,957,1237,280
6502,0,0,20,0,-20
6503,1,1,856,1413,557
6504,1,1,253,2136,1883
6505,0,0,122,0,-122
6506,0,0,0,0,0
6507,0,0,3,0,-3
6508,1,1,257,1306,1049
6509,1,1,215,1205,990
6510,0,0,34,0,-34
6511,1,1,482,1423,941
6512,0,0,16,0,-16
6513,1,1,192,1256,1064
6514,1,0,8,0,-8
6515,1,0,153,0,-153
6516,1,0,18,0,-18
6517,1,1,760,1842,1082
6518,0,0,80,0,-80
6519,0,0,9,0,-9
6520,1,1,260,1640,1380
6521,1,0,96,0,-96
6522,1,0,18,0,-18
6523,1,0,75,0,-75
6524,0,0,17,0,-17
6525,1,0,6,0,-6
6526,1,1,949,2198,1249
6527,1,1,381,1227,846
6528,1,0,153,0,-153
6529,0,0,5,0,-5
6530,1,1,250,1240,990
6531,1,0,72,0,-72
6532,1,0,3,0,-3
6533,0,0,12,0,-12
6534,0,0,52,0,-52
6535,1,0,27,0,-27
6536,1,0,29,0,-29
6537,1,1,793,1269,476
6538,0,0,40,0,-40
6539,1,1,331,1383,1052
6540,1,1,153,1679,1526
6541,0,0,45,0,-45
6542,1,0,4,0,-4
6543,1,0,56,0,-56
6544,1,0,161,0,-161
6545,1,1,121,1548,1427
6546,0,0,162,0,-162
6547,0,0,185,0,-185
6548,1,1,896,1306,410
6549,1,0,65,0,-65
6550,0,0,50,0,-50
6551,1,1,304,1800,1496
6552,1,0,40,0,-40
6553,0,0,31,0,-31
6554,1,1,233,1817,1584
6555,0,0,125,0,-125
6556,0,0,86,0,-86
6557,0,0,28,0,-28
6558,1,0,33,0,-33
6559,1,0,13,0,-13
6560,1,1,348,1239,891
6561,1,1,60,2369,2309
6562,1,1,107,2801,2694
6563,1,1,1554,2078,524
6564,0,0,10,0,-10
6565,0,0,138,0,-138
6566,1,1,677,3603,2926
6567,1,0,2,0,-2
6568,1,0,38,0,-38
6569,1,0,89,0,-89
6570,0,0,6,0,-6
6571,1,0,27,0,-27
6572,0,0,1,0,-1
6573,0,0,7,0,-7
6574,0,0,24,0,-24
6575,1,1,1231,1381,150
6576,1,0,22,0,-22
6577,0,0,4,0,-4
6578,1,1,258,1671,1413
6579,0,0,43,0,-43
6580,0,0,144,0,-144
6581,0,0,4,0,-4
6582,1,1,252,1744,1492
6583,1,0,3,0,-3
6584,1,1,897,1424,527
6585,0,0,32,0,-32
6586,0,0,23,0,-23
6587,1,0,38,0,-38
6588,1,1,1087,1931,844
6589,0,0,7,0,-7
6590,1,0,58,0,-58
6591,1,0,13,0,-13
6592,0,0,23,0,-23
6593,1,1,241,1625,1384
6594,1,0,78,0,-78
6595,1,0,14,0,-14
6596,1,1,290,1217,927
6597,1,0,21,0,-21
6598,0,0,1,0,-1
6599,1,1,488,1390,902
6600,1,1,259,1716,1457
6601,1,0,35,0,-35
6602,0,0,1,0,-1
6603,1,0,14,0,-14
6604,1,0,54,0,-54
6605,1,1,102,1406,1304
6606,1,1,278,1300,1022
6607,0,0,168,0,-168
6608,1,0,23,0,-23
6609,0,0,25,0,-25
6610,1,0,5,0,-5
6611,1,0,76,0,-76
6612,1,1,428,1206,778
6613,0,0,37,0,-37
6614,1,0,0,0,0
6615,0,0,20,0,-20
6616,1,1,1566,1342,-224
6617,1,1,600,1226,626
6618,0,0,25,0,-25
6619,1,0,30,0,-30
6620,0,0,13,0,-13
6621,1,1,294,1366,1072
6622,0,0,40,0,-40
6623,0,0,18,0,-18
6624,1,1,256,1618,1362
6625,1,0,63,0,-63
6626,0,0,24,0,-24
6627,1,1,468,1529,1061
6628,1,1,1472,1280,-192
6629,1,1,153,1386,1233
6630,1,0,17,0,-17
6631,0,0,88,0,-88
6632,1,0,28,0,-28
6633,0,0,8,0,-8
6634,0,0,28,0,-28
6635,1,0,174,0,-174
6636,0,0,94,0,-94
6637,1,1,484,1559,1075
6638,0,0,1,0,-1
6639,1,0,18,0,-18
6640,0,0,7,0,-7
6641,1,0,143,0,-143
6642,1,1,1229,1898,669
6643,1,0,35,0,-35
6644,1,0,12,0,-12
6645,1,1,152,1239,1087
6646,1,0,57,0,-57
6647,1,0,17,0,-17
6648,0,0,12,0,-12
6649,0,0,8,0,-8
6650,1,1,1140,1769,629
6651,1,0,49,0,-49
6652,1,0,73,0,-73
6653,0,0,10,0,-10
6654,0,0,24,0,-24
6655,1,1,148,1395,1247
6656,0,0,144,0,-144
6657,0,0,14,0,-14
6658,1,1,908,3202,2294
6659,1,1,853,1737,884
6660,1,1,842,1466,624
6661,0,0,74,0,-74
6662,1,1,210,1261,1051
6663,1,0,104,0,-104
6664,1,1,651,1938,1287
6665,0,0,96,0,-96
6666,1,1,614,1207,593
6667,0,0,43,0,-43
6668,1,0,29,0,-29
6669,0,0,22,0,-22
6670,1,1,277,1254,977
6671,0,0,64,0,-64
6672,0,0,146,0,-146
6673,1,1,164,1225,1061
6674,1,1,55,1200,1145
6675,1,0,51,0,-51
6676,0,0,60,0,-60
6677,1,0,12,0,-12
6678,0,0,12,0,-12
6679,0,0,20,0,-20
6680,0,0,20,0,-20
6681,0,0,125,0,-125
6682,0,0,72,0,-72
6683,1,0,28,0,-28
6684,1,1,382,1335,953
6685,1,1,1035,1894,859
6686,0,0,61,0,-61
6687,0,0,29,0,-29
6688,1,1,570,1436,866
6689,1,1,601,1372,771
6690,1,0,87,0,-87
6691,1,1,1118,1979,861
6692,1,0,4,0,-4
6693,1,1,609,1532,923
6694,1,0,78,0,-78
6695,1,0,33,0,-33
6696,1,0,3,0,-3
6697,1,0,41,0,-41
6698,0,0,40,0,-40
6699,1,0,110,0,-110
6700,0,0,5,0,-5
6701,1,1,222,1219,997
6702,1,1,147,1436,1289
6703,1,1,219,1366,1147
6704,0,0,23,0,-23
6705,1,1,92,1425,1333
6706,1,1,3165,2430,-735
6707,1,0,14,0,-14
6708,1,0,151,0,-151
6709,1,1,1334,1235,-99
6710,1,1,1128,1432,304
6711,0,0,7,0,-7
6712,0,0,49,0,-49
6713,1,0,10,0,-10
6714,1,1,712,2683,1971
6715,1,0,6,0,-6
6716,0,0,41,0,-41
6717,1,0,173,0,-173
6718,0,0,47,0,-47
6719,1,1,344,2265,1921
6720,1,1,243,2842,2599
6721,1,1,1139,1201,62
6722,1,1,261,2430,2169
6723,0,0,160,0,-160
6724,0,0,69,0,-69
6725,0,0,184,0,-184
6726,0,0,15,0,-15
6727,0,0,48,0,-48
6728,1,1,161,2018,1857
6729,0,0,51,0,-51
6730,0,0,1,0,-1
6731,0,0,6,0,-6
6732,0,0,6,0,-6
6733,0,0,5,0,-5
6734,1,1,179,1204,1025
6735,1,1,133,1604,1471
6736,0,0,52,0,-52
6737,1,1,229,1754,1525
6738,1,1,188,1463,1275
6739,1,1,861,2627,1766
6740,0,0,218,0,-218
6741,0,0,31,0,-31
6742,0,0,46,0,-46
6743,0,0,8,0,-8
6744,0,0,10,0,-10
6745,1,1,112,1442,1330
6746,0,0,25,0,-25
6747,0,0,49,0,-49
6748,0,0,57,0,-57
6749,0,0,29,0,-29
6750,1,0,83,0,-83
6751,0,0,2,0,-2
6752,1,1,1302,1213,-89
6753,1,1,310,1385,1075
6754,1,0,62,0,-62
6755,1,0,87,0,-87
6756,0,0,53,0,-53
6757,0,0,2,0,-2
6758,0,0,48,0,-48
6759,1,0,40,0,-40
6760,1,0,134,0,-134
6761,1,1,222,1389,1167
6762,1,0,40,0,-40
6763,1,1,1669,3640,1971
6764,1,0,48,0,-48
6765,0,0,66,0,-66
6766,1,0,32,0,-32
6767,0,0,140,0,-140
6768,1,0,70,0,-70
6769,1,1,514,1237,723
6770,1,0,81,0,-81
6771,1,1,155,1347,1192
6772,1,1,155,1841,1686
6773,0,0,17,0,-17
6774,0,0,10,0,-10
6775,0,0,15,0,-15
6776,1,1,405,1354,949
6777,1,0,28,0,-28
6778,1,0,59,0,-59
6779,0,0,10,0,-10
6780,0,0,62,0,-62
6781,1,1,296,1201,905
6782,1,0,16,0,-16
6783,1,0,45,0,-45
6784,1,0,94,0,-94
6785,0,0,18,0,-18
6786,1,0,2,0,-2
6787,1,0,0,0,0
6788,1,1,83,1814,1731
6789,1,1,778,2505,1727
6790,0,0,62,0,-62
6791,0,0,4,0,-4
6792,1,0,35,0,-35
6793,1,0,18,0,-18
6794,1,0,18,0,-18
6795,0,0,169,0,-169
6796,0,0,107,0,-107
6797,0,0,54,0,-54
6798,1,1,681,2469,1788
6799,1,0,31,0,-31
6800,0,0,82,0,-82
6801,0,0,79,0,-79
6802,1,0,30,0,-30
6803,1,1,249,1556,1307
6804,1,0,101,0,-101
6805,0,0,8,0,-8
6806,1,1,262,3320,3058
6807,1,1,342,1278,936
6808,1,1,286,1234,948
6809,1,0,16,0,-16
6810,1,1,335,1203,868
6811,1,1,228,1270,1042
6812,1,1,146,1485,1339
6813,0,0,16,0,-16
6814,1,1,1262,2362,1100
6815,1,0,102,0,-102
6816,0,0,15,0,-15
6817,1,0,79,0,-79
6818,1,1,191,1264,1073
6819,1,1,191,1227,1036
6820,0,0,34,0,-34
6821,0,0,82,0,-82
6822,1,1,486,1725,1239
6823,1,0,8,0,-8
6824,1,0,17,0,-17
6825,0,0,67,0,-67
6826,1,1,61,1856,1795
6827,0,0,29,0,-29
6828,0,0,13,0,-13
6829,1,0,15,0,-15
6830,0,0,167,0,-167
6831,0,0,18,0,-18
6832,0,0,27,0,-27
6833,0,0,18,0,-18
6834,1,1,151,1281,1130
6835,1,0,141,0,-141
6836,0,0,4,0,-4
6837,0,0,30,0,-30
6838,0,0,49,0,-49
6839,0,0,4,0,-4
6840,1,0,60,0,-60
6841,1,1,371,1221,850
6842,1,0,53,0,-53
6843,0,0,15,0,-15
6844,1,0,7,0,-7
6845,0,0,4,0,-4
6846,1,0,17,0,-17
6847,0,0,12,0,-12
6848,1,1,118,1939,1821
6849,1,0,46,0,-46
6850,0,0,63,0,-63
6851,0,0,43,0,-43
6852,1,1,69,1254,1185
6853,0,0,52,0,-52
6854,0,0,0,0,0
6855,0,0,165,0,-165
6856,1,0,1,0,-1
6857,1,0,24,0,-24
6858,1,1,127,1460,1333
6859,0,0,9,0,-9
6860,1,1,934,1964,1030
6861,1,0,54,0,-54
6862,1,1,6,1356,1350
6863,0,0,104,0,-104
6864,1,0,13,0,-13
6865,1,0,9,0,-9
6866,0,0,18,0,-18
6867,1,1,521,1376,855
6868,1,1,169,1298,1129
6869,0,0,16,0,-16
6870,0,0,20,0,-20
6871,1,1,507,1504,997
6872,1,1,297,1297,1000
6873,0,0,33,0,-33
6874,0,0,23,0,-23
6875,1,1,142,1368,1226
6876,1,0,40,0,-40
6877,0,0,12,0,-12
6878,0,0,18,0,-18
6879,1,1,937,1342,405
6880,1,0,0,0,0
6881,0,0,74,0,-74
6882,0,0,74,0,-74
6883,0,0,36,0,-36
6884,0,0,165,0,-165
6885,0,0,43,0,-43
6886,0,0,41,0,-41
6887,1,1,2354,1639,-715
6888,0,0,20,0,-20
6889,1,0,96,0,-96
6890,0,0,0,0,0
6891,1,0,28,0,-28
6892,1,0,52,0,-52
6893,0,0,17,0,-17
6894,1,1,446,1694,1248
6895,1,1,224,1339,1115
6896,1,1,496,1230,734
6897,1,1,1091,1486,395
6898,0,0,106,0,-106
6899,1,1,771,1397,626
6900,1,0,8,0,-8
6901,0,0,28,0,-28
6902,1,1,1900,1477,-423
6903,1,0,7,0,-7
6904,1,0,35,0,-35
6905,0,0,77,0,-77
6906,0,0,10,0,-10
6907,0,0,3,0,-3
6908,1,0,8,0,-8
6909,1,1,592,1244,652
6910,1,1,327,1270,943
6911,1,1,135,1295,1160
6912,1,1,655,1409,754
6913,1,1,226,1477,1251
6914,1,1,157,1654,1497
6915,1,1,317,1232,915
6916,1,1,413,1653,1240
6917,1,1,490,1801,1311
6918,1,1,1014,1325,311
6919,1,0,38,0,-38
6920,0,0,16,0,-16
6921,1,0,33,0,-33
6922,1,0,20,0,-20
6923,1,1,61,1786,1725
6924,1,1,825,3702,2877
6925,0,0,18,0,-18
6926,0,0,77,0,-77
6927,1,0,42,0,-42
6928,1,0,8,0,-8
6929,0,0,13,0,-13
6930,0,0,32,0,-32
6931,1,1,229,1580,1351
6932,1,1,1087,1257,170
6933,1,0,32,0,-32
6934,1,1,303,1440,1137
6935,0,0,13,0,-13
6936,1,0,99,0,-99
6937,0,0,102,0,-102
6938,0,0,59,0,-59
6939,1,0,265,0,-265
6940,0,0,169,0,-169
6941,0,0,35,0,-35
6942,1,0,6,0,-6
6943,0,0,72,0,-72
6944,0,0,14,0,-14
6945,1,1,24,1299,1275
6946,1,0,55,0,-55
6947,1,0,64,0,-64
6948,1,1,529,1479,950
6949,1,0,60,0,-60
6950,0,0,58,0,-58
6951,0,0,32,0,-32
6952,1,0,13,0,-13
6953,1,0,2,0,-2
6954,0,0,10,0,-10
6955,0,0,103,0,-103
6956,1,0,243,0,-243
6957,1,1,137,1241,1104
6958,1,0,86,0,-86
6959,1,0,20,0,-20
6960,0,0,54,0,-54
6961,0,0,91,0,-91
6962,1,0,77,0,-77
6963,0,0,53,0,-53
6964,1,0,12,0,-12
6965,1,0,20,0,-20
6966,0,0,35,0,-35
6967,0,0,74,0,-74
6968,1,0,13,0,-13
6969,1,0,186,0,-186
6970,1,0,11,0,-11
6971,0,0,238,0,-238
6972,0,0,22,0,-22
6973,1,1,475,1538,1063
6974,0,0,84,0,-84
6975,1,0,41,0,-41
6976,1,1,121,1289,1168
6977,1,1,549,1303,754
6978,1,0,124,0,-124
6979,1,1,306,1788,1482
6980,0,0,59,0,-59
6981,1,1,1004,1307,303
6982,0,0,78,0,-78
6983,1,1,38,1266,1228
6984,1,1,818,2911,2093
6985,1,1,203,1303,1100
6986,1,0,30,0,-30
6987,0,0,0,0,0
6988,0,0,61,0,-61
6989,0,0,11,0,-11
6990,1,0,106,0,-106
6991,1,1,164,1232,1068
6992,0,0,47,0,-47
6993,1,0,154,0,-154
6994,1,0,57,0,-57
6995,1,1,165,1452,1287
6996,1,0,34,0,-34
6997,1,0,12,0,-12
6998,0,0,23,0,-23
6999,1,1,233,1367,1134
7000,1,1,192,2601,2409
7001,0,0,113,0,-113
7002,0,0,0,0,0
7003,1,1,454,1290,836
7004,1,1,663,1271,608
7005,1,0,69,0,-69
7006,1,0,10,0,-10
7007,1,0,1,0,-1
7008,1,1,175,1965,1790
7009,0,0,28,0,-28
7010,1,1,334,1613,1279
7011,1,0,23,0,-23
7012,0,0,22,0,-22
7013,1,1,146,1417,1271
7014,0,0,100,0,-100
7015,1,0,74,0,-74
7016,1,1,719,1270,551
7017,1,1,1245,1415,170
7018,1,1,184,1525,1341
7019,0,0,6,0,-6
7020,1,1,69,1724,1655
7021,1,0,25,0,-25
7022,0,0,137,0,-137
7023,0,0,8,0,-8
7024,1,0,85,0,-85
7025,1,1,434,1690,1256
7026,1,0,7,0,-7
7027,1,0,16,0,-16
7028,1,1,663,1832,1169
7029,0,0,6,0,-6
7030,1,0,31,0,-31
7031,1,0,52,0,-52
7032,1,1,101,1454,1353
7033,1,1,74,3938,3864
7034,1,1,932,1578,646
7035,0,0,11,0,-11
7036,0,0,16,0,-16
7037,0,0,25,0,-25
7038,1,1,1167,1286,119
7039,1,0,68,0,-68
7040,1,0,24,0,-24
7041,1,0,27,0,-27
7042,0,0,8,0,-8
7043,0,0,109,0,-109
7044,0,0,3,0,-3
7045,1,1,293,1726,1433
7046,1,1,635,2172,1537
7047,1,1,578,1222,644
7048,1,0,33,0,-33
7049,1,0,131,0,-131
7050,1,0,21,0,-21
7051,0,0,45,0,-45
7052,1,1,215,1332,1117
7053,0,0,50,0,-50
7054,0,0,99,0,-99
7055,1,1,1962,1203,-759
7056,1,0,45,0,-45
7057,1,0,92,0,-92
7058,0,0,14,0,-14
7059,0,0,28,0,-28
7060,0,0,29,0,-29
7061,0,0,64,0,-64
7062,1,1,1664,1336,-328
7063,0,0,17,0,-17
7064,0,0,22,0,-22
7065,0,0,18,0,-18
7066,1,1,1585,1756,171
7067,0,0,27,0,-27
7068,1,1,1330,1204,-126
7069,0,0,41,0,-41
7070,1,0,53,0,-53
7071,1,0,31,0,-31
7072,0,0,2,0,-2
7073,1,0,13,0,-13
7074,0,0,18,0,-18
7075,1,1,399,1414,1015
7076,0,0,0,0,0
7077,1,0,78,0,-78
7078,0,0,118,0,-118
7079,0,0,26,0,-26
7080,1,0,38,0,-38
7081,1,1,206,2848,2642
7082,0,0,27,0,-27
7083,1,0,72,0,-72
7084,1,0,27,0,-27
7085,0,0,138,0,-138
7086,0,0,108,0,-108
7087,1,1,314,1830,1516
7088,1,1,169,1356,1187
7089,0,0,40,0,-40
7090,1,1,418,1590,1172
7091,0,0,38,0,-38
7092,0,0,51,0,-51
7093,0,0,33,0,-33
7094,1,1,239,1652,1413
7095,1,0,55,0,-55
7096,1,0,36,0,-36
7097,0,0,36,0,-36
7098,1,1,802,1358,556
7099,0,0,84,0,-84
7100,1,1,907,1258,351
7101,0,0,57,0,-57
7102,0,0,36,0,-36
7103,1,0,106,0,-106
7104,0,0,101,0,-101
7105,0,0,5,0,-5
7106,0,0,11,0,-11
7107,1,1,190,1240,1050
7108,1,1,363,1433,1070
7109,1,1,273,1535,1262
7110,1,1,871,1607,736
7111,0,0,23,0,-23
7112,0,0,4,0,-4
7113,1,0,20,0,-20
7114,1,1,9,1591,1582
7115,1,1,986,1446,460
7116,1,1,59,1650,1591
7117,1,1,459,1549,1090
7118,1,1,325,1235,910
7119,1,0,143,0,-143
7120,1,1,596,1442,846
7121,1,1,77,1313,1236
7122,0,0,36,0,-36
7123,1,0,7,0,-7
7124,1,0,6,0,-6
7125,0,0,0,0,0
7126,1,0,14,0,-14
7127,0,0,136,0,-136
7128,1,0,10,0,-10
7129,0,0,81,0,-81
7130,1,0,20,0,-20
7131,1,1,36,1630,1594
7132,1,0,42,0,-42
7133,1,1,437,1372,935
7134,0,0,6,0,-6
7135,0,0,28,0,-28
7136,0,0,8,0,-8
7137,1,0,4,0,-4
7138,0,0,10,0,-10
7139,0,0,0,0,0
7140,1,0,232,0,-232
7141,0,0,33,0,-33
7142,0,0,25,0,-25
7143,1,0,4,0,-4
7144,1,0,2,0,-2
7145,1,0,65,0,-65
7146,0,0,1,0,-1
7147,1,1,801,1749,948
7148,1,1,729,1259,530
7149,1,1,376,1259,883
7150,1,0,20,0,-20
7151,1,1,424,1846,1422
7152,1,0,3,0,-3
7153,1,0,4,0,-4
7154,0,0,40,0,-40
7155,0,0,164,0,-164
7156,1,0,27,0,-27
7157,1,1,98,1220,1122
7158,1,0,39,0,-39
7159,0,0,30,0,-30
7160,1,0,51,0,-51
7161,1,1,46,1338,1292
7162,1,1,884,2317,1433
7163,0,0,15,0,-15
7164,0,0,35,0,-35
7165,1,1,800,1414,614
7166,1,0,32,0,-32
7167,1,0,22,0,-22
7168,1,1,233,1382,1149
7169,0,0,48,0,-48
7170,1,0,36,0,-36
7171,1,1,247,1828,1581
7172,1,0,18,0,-18
7173,1,1,301,1394,1093
7174,1,0,0,0,0
7175,1,1,1167,1708,541
7176,1,1,1713,1489,-224
7177,0,0,21,0,-21
7178,0,0,138,0,-138
7179,1,0,32,0,-32
7180,0,0,102,0,-102
7181,1,1,235,1344,1109
7182,1,0,13,0,-13
7183,1,0,2,0,-2
7184,1,1,124,1208,1084
7185,0,0,24,0,-24
7186,0,0,23,0,-23
7187,0,0,66,0,-66
7188,0,0,2,0,-2
7189,1,1,270,1318,1048
7190,1,1,207,1837,1630
7191,1,0,81,0,-81
7192,1,1,334,4021,3687
7193,1,0,32,0,-32
7194,1,0,36,0,-36
7195,0,0,15,0,-15
7196,1,0,257,0,-257
7197,1,1,1425,1934,509
7198,1,1,141,1579,1438
7199,1,1,348,1333,985
7200,1,1,1399,1985,586
7201,1,1,822,2036,1214
7202,1,0,15,0,-15
7203,1,0,15,0,-15
7204,0,0,31,0,-31
7205,1,1,417,1276,859
7206,0,0,39,0,-39
7207,0,0,30,0,-30
7208,1,1,21,1259,1238
7209,0,0,149,0,-149
7210,1,1,359,1383,1024
7211,1,0,33,0,-33
7212,1,1,870,1340,470
7213,0,0,33,0,-33
7214,1,1,284,1342,1058
7215,1,0,97,0,-97
7216,1,0,88,0,-88
7217,1,0,22,0,-22
7218,1,0,8,0,-8
7219,0,0,10,0,-10
7220,1,1,230,1228,998
7221,1,1,458,1217,759
7222,1,0,24,0,-24
7223,1,0,40,0,-40
7224,1,1,244,1443,1199
7225,1,1,375,1861,1486
7226,1,0,13,0,-13
7227,1,1,375,1340,965
7228,1,1,451,1409,958
7229,0,0,31,0,-31
7230,1,0,16,0,-16
7231,1,1,680,1570,890
7232,1,0,13,0,-13
7233,1,1,540,1214,674
7234,1,1,374,1485,1111
7235,1,1,421,1339,918
7236,0,0,50,0,-50
7237,0,0,156,0,-156
7238,1,1,742,1276,534
7239,1,0,27,0,-27
7240,1,1,1149,1506,357
7241,0,0,22,0,-22
7242,1,1,852,1305,453
7243,1,1,416,1657,1241
7244,0,0,2,0,-2
7245,1,1,562,1923,1361
7246,0,0,38,0,-38
7247,0,0,129,0,-129
7248,1,1,335,1477,1142
7249,1,0,48,0,-48
7250,1,1,231,1202,971
7251,1,0,62,0,-62
7252,1,1,865,1291,426
7253,0,0,130,0,-130
7254,1,0,22,0,-22
7255,1,1,363,1243,880
7256,1,0,83,0,-83
7257,1,0,55,0,-55
7258,0,0,40,0,-40
7259,1,0,8,0,-8
7260,0,0,69,0,-69
7261,1,1,626,1882,1256
7262,0,0,27,0,-27
7263,1,0,1,0,-1
7264,1,0,139,0,-139
7265,1,1,275,2109,1834
7266,1,0,73,0,-73
7267,0,0,41,0,-41
7268,0,0,11,0,-11
7269,0,0,13,0,-13
7270,1,1,73,1536,1463
7271,1,1,203,1762,1559
7272,1,0,29,0,-29
7273,1,0,49,0,-49
7274,0,0,1,0,-1
7275,1,0,3,0,-3
7276,0,0,102,0,-102
7277,1,1,468,1283,815
7278,1,0,22,0,-22
7279,0,0,34,0,-34
7280,0,0,101,0,-101
7281,1,1,157,4582,4425
7282,1,0,108,0,-108
7283,0,0,42,0,-42
7284,0,0,61,0,-61
7285,1,1,432,1457,1025
7286,1,1,181,1228,1047
7287,0,0,83,0,-83
7288,0,0,84,0,-84
7289,1,0,11,0,-11
7290,0,0,86,0,-86
7291,0,0,40,0,-40
7292,0,0,11,0,-11
7293,1,1,47,1770,1723
7294,0,0,177,0,-177
7295,1,0,180,0,-180
7296,1,0,53,0,-53
7297,1,0,30,0,-30
7298,1,0,16,0,-16
7299,0,0,56,0,-56
7300,1,0,121,0,-121
7301,0,0,14,0,-14
7302,0,0,11,0,-11
7303,0,0,15,0,-15
7304,0,0,59,0,-59
7305,0,0,1,0,-1
7306,1,0,20,0,-20
7307,0,0,70,0,-70
7308,1,0,2,0,-2
7309,1,0,73,0,-73
7310,0,0,32,0,-32
7311,0,0,6,0,-6
7312,1,0,351,0,-351
7313,1,1,110,2564,2454
7314,0,0,6,0,-6
7315,0,0,109,0,-109
7316,0,0,59,0,-59
7317,0,0,222,0,-222
7318,1,0,180,0,-180
7319,0,0,60,0,-60
7320,1,0,26,0,-26
7321,1,1,238,1241,1003
7322,1,1,283,1202,919
7323,1,0,90,0,-90
7324,0,0,94,0,-94
7325,1,0,96,0,-96
7326,0,0,8,0,-8
7327,1,0,49,0,-49
7328,1,0,4,0,-4
7329,1,0,49,0,-49
7330,0,0,161,0,-161
7331,1,0,87,0,-87
7332,0,0,14,0,-14
7333,1,1,363,1287,924
7334,0,0,11,0,-11
7335,1,1,897,2040,1143
7336,1,0,54,0,-54
7337,1,0,1,0,-1
7338,1,0,4,0,-4
7339,1,0,13,0,-13
7340,0,0,4,0,-4
7341,0,0,66,0,-66
7342,1,1,116,1303,1187
7343,1,1,13,1252,1239
7344,0,0,108,0,-108
7345,1,1,342,1488,1146
7346,0,0,164,0,-164
7347,1,0,46,0,-46
7348,1,1,425,1332,907
7349,0,0,105,0,-105
7350,1,0,35,0,-35
7351,0,0,112,0,-112
7352,0,0,103,0,-103
7353,1,1,793,1521,728
7354,1,0,10,0,-10
7355,1,0,90,0,-90
7356,0,0,22,0,-22
7357,1,1,228,1405,1177
7358,0,0,27,0,-27
7359,1,0,26,0,-26
7360,1,1,166,1627,1461
7361,0,0,5,0,-5
7362,0,0,106,0,-106
7363,0,0,7,0,-7
7364,1,1,305,1272,967
7365,1,0,91,0,-91
7366,1,0,154,0,-154
7367,0,0,35,0,-35
7368,1,0,82,0,-82
7369,1,0,123,0,-123
7370,1,0,2,0,-2
7371,1,1,300,1461,1161
7372,1,0,97,0,-97
7373,1,1,1358,1544,186
7374,1,0,38,0,-38
7375,0,0,7,0,-7
7376,0,0,42,0,-42
7377,1,1,430,1802,1372
7378,0,0,69,0,-69
7379,0,0,19,0,-19
7380,0,0,5,0,-5
7381,1,1,60,1575,1515
7382,1,0,13,0,-13
7383,1,0,144,0,-144
7384,0,0,24,0,-24
7385,0,0,45,0,-45
7386,0,0,24,0,-24
7387,1,0,63,0,-63
7388,1,1,729,1251,522
7389,0,0,76,0,-76
7390,0,0,18,0,-18
7391,1,0,53,0,-53
7392,0,0,15,0,-15
7393,0,0,58,0,-58
7394,1,0,11,0,-11
7395,1,1,430,1607,1177
7396,1,1,718,1619,901
7397,1,0,14,0,-14
7398,0,0,17,0,-17
7399,1,1,1105,1201,96
7400,0,0,58,0,-58
7401,0,0,16,0,-16
7402,1,1,117,1246,1129
7403,1,1,232,1359,1127
7404,0,0,76,0,-76
7405,0,0,77,0,-77
7406,0,0,47,0,-47
7407,0,0,33,0,-33
7408,1,0,77,0,-77
7409,0,0,115,0,-115
7410,1,0,8,0,-8
7411,1,1,934,1236,302
7412,1,0,186,0,-186
7413,1,1,66,1653,1587
7414,1,1,27,1478,1451
7415,0,0,6,0,-6
7416,1,0,1,0,-1
7417,1,1,157,1726,1569
7418,1,0,43,0,-43
7419,1,0,32,0,-32
7420,1,0,59,0,-59
7421,0,0,127,0,-127
7422,1,0,69,0,-69
7423,0,0,45,0,-45
7424,0,0,77,0,-77
7425,1,0,17,0,-17
7426,1,1,982,1725,743
7427,0,0,6,0,-6
7428,1,1,304,1257,953
7429,1,0,23,0,-23
7430,1,0,1,0,-1
7431,1,1,501,2006,1505
7432,0,0,19,0,-19
7433,1,0,0,0,0
7434,1,0,13,0,-13
7435,1,1,614,1544,930
7436,1,1,766,2434,1668
7437,0,0,70,0,-70
7438,1,0,39,0,-39
7439,1,1,804,1232,428
7440,1,0,79,0,-79
7441,1,0,31,0,-31
7442,1,1,236,2026,1790
7443,1,0,21,0,-21
7444,0,0,8,0,-8
7445,1,0,23,0,-23
7446,1,0,28,0,-28
7447,0,0,19,0,-19
7448,1,1,575,1948,1373
7449,0,0,33,0,-33
7450,0,0,103,0,-103
7451,1,0,4,0,-4
7452,1,0,4,0,-4
7453,1,1,1323,2104,781
7454,1,1,221,1327,1106
7455,1,1,280,1433,1153
7456,0,0,38,0,-38
7457,1,0,40,0,-40
7458,0,0,50,0,-50
7459,1,1,701,2868,2167
7460,1,0,32,0,-32
7461,1,1,1949,1529,-420
7462,0,0,60,0,-60
7463,0,0,12,0,-12
7464,0,0,245,0,-245
7465,0,0,76,0,-76
7466,1,1,510,1688,1178
7467,0,0,29,0,-29
7468,0,0,133,0,-133
7469,1,1,78,1204,1126
7470,0,0,52,0,-52
7471,1,1,297,1802,1505
7472,0,0,36,0,-36
7473,1,1,1356,1446,90
7474,1,0,3,0,-3
7475,1,0,68,0,-68
7476,0,0,74,0,-74
7477,1,1,171,1374,1203
7478,1,1,73,1967,1894
7479,0,0,46,0,-46
7480,1,0,82,0,-82
7481,0,0,53,0,-53
7482,0,0,56,0,-56
7483,1,0,123,0,-123
7484,1,1,473,3714,3241
7485,1,1,508,1336,828
7486,0,0,18,0,-18
7487,1,0,48,0,-48
7488,1,0,30,0,-30
7489,1,0,78,0,-78
7490,1,0,24,0,-24
7491,1,1,121,1640,1519
7492,1,0,3,0,-3
7493,0,0,6,0,-6
7494,1,0,121,0,-121
7495,1,0,79,0,-79
7496,0,0,59,0,-59
7497,1,1,530,3243,2713
7498,1,0,1,0,-1
7499,0,0,93,0,-93
7500,1,1,182,5432,5250
7501,0,0,36,0,-36
7502,1,0,38,0,-38
7503,0,0,20,0,-20
7504,1,1,56,1510,1454
7505,1,1,361,1725,1364
7506,0,0,25,0,-25
7507,1,0,104,0,-104
7508,1,0,1,0,-1
7509,1,1,92,1308,1216
7510,1,1,1741,1270,-471
7511,1,0,13,0,-13
7512,1,0,2,0,-2
7513,1,0,0,0,0
7514,1,0,54,0,-54
7515,0,0,49,0,-49
7516,1,1,390,1334,944
7517,0,0,113,0,-113
7518,0,0,78,0,-78
7519,1,0,58,0,-58
7520,1,1,263,1232,969
7521,0,0,21,0,-21
7522,0,0,42,0,-42
7523,1,1,158,1441,1283
7524,1,1,797,1959,1162
7525,0,0,127,0,-127
7526,1,1,625,1201,576
7527,1,1,1469,1292,-177
7528,0,0,95,0,-95
7529,0,0,9,0,-9
7530,0,0,59,0,-59
7531,0,0,28,0,-28
7532,1,0,35,0,-35
7533,1,0,36,0,-36
7534,0,0,62,0,-62
7535,1,0,94,0,-94
7536,1,0,55,0,-55
7537,1,0,11,0,-11
7538,0,0,117,0,-117
7539,0,0,2,0,-2
7540,1,0,37,0,-37
7541,0,0,165,0,-165
7542,1,0,20,0,-20
7543,1,1,509,1810,1301
7544,0,0,68,0,-68
7545,0,0,56,0,-56
7546,1,1,1481,2084,603
7547,0,0,0,0,0
7548,1,0,37,0,-37
7549,0,0,19,0,-19
7550,0,0,70,0,-70
7551,1,1,338,1291,953
7552,1,0,36,0,-36
7553,1,1,1057,1227,170
7554,1,1,409,1773,1364
7555,1,0,52,0,-52
7556,1,0,19,0,-19
7557,1,1,270,1324,1054
7558,1,0,70,0,-70
7559,1,0,11,0,-11
7560,0,0,125,0,-125
7561,0,0,21,0,-21
7562,0,0,17,0,-17
7563,1,1,251,1361,1110
7564,0,0,19,0,-19
7565,1,1,45,1252,1207
7566,0,0,43,0,-43
7567,0,0,28,0,-28
7568,1,1,934,1218,284
7569,1,1,204,1430,1226
7570,1,1,1127,1283,156
7571,1,0,10,0,-10
7572,1,1,269,1366,1097
7573,1,1,314,1373,1059
7574,1,1,378,2015,1637
7575,0,0,8,0,-8
7576,0,0,21,0,-21
7577,0,0,67,0,-67
7578,1,1,626,1349,723
7579,0,0,23,0,-23
7580,0,0,19,0,-19
7581,1,0,31,0,-31
7582,0,0,56,0,-56
7583,1,0,65,0,-65
7584,1,1,302,1342,1040
7585,1,0,129,0,-129
7586,0,0,10,0,-10
7587,0,0,74,0,-74
7588,1,1,593,1458,865
7589,0,0,96,0,-96
7590,0,0,256,0,-256
7591,1,1,737,1278,541
7592,0,0,145,0,-145
7593,1,0,88,0,-88
7594,0,0,66,0,-66
7595,1,1,47,1615,1568
7596,0,0,102,0,-102
7597,0,0,36,0,-36
7598,1,0,71,0,-71
7599,1,1,468,2601,2133
7600,0,0,15,0,-15
7601,1,1,315,1214,899
7602,0,0,0,0,0
7603,1,0,16,0,-16
7604,1,1,28,1295,1267
7605,0,0,65,0,-65
7606,1,0,4,0,-4
7607,0,0,22,0,-22
7608,0,0,45,0,-45
7609,0,0,83,0,-83
7610,1,1,181,1223,1042
7611,1,1,61,1341,1280
7612,1,0,1,0,-1
7613,1,1,147,1234,1087
7614,1,1,1213,1226,13
7615,1,1,540,1269,729
7616,0,0,5,0,-5
7617,0,0,13,0,-13
7618,1,1,199,1267,1068
7619,0,0,6,0,-6
7620,0,0,86,0,-86
7621,0,0,4,0,-4
7622,1,0,36,0,-36
7623,1,0,8,0,-8
7624,1,0,62,0,-62
7625,1,1,133,1591,1458
7626,0,0,39,0,-39
7627,0,0,30,0,-30
7628,1,1,1536,1508,-28
7629,0,0,10,0,-10
7630,0,0,77,0,-77
7631,0,0,37,0,-37
7632,1,1,162,1865,1703
7633,1,0,76,0,-76
7634,1,1,685,2120,1435
7635,0,0,20,0,-20
7636,1,1,754,1367,613
7637,1,0,53,0,-53
7638,1,1,88,1201,1113
7639,1,1,472,1673,1201
7640,1,1,1166,1224,58
7641,1,0,61,0,-61
7642,1,1,1181,1887,706
7643,1,0,41,0,-41
7644,0,0,31,0,-31
7645,0,0,10,0,-10
7646,1,0,124,0,-124
7647,1,0,39,0,-39
7648,0,0,145,0,-145
7649,1,0,55,0,-55
7650,1,1,1161,1246,85
7651,1,0,39,0,-39
7652,0,0,10,0,-10
7653,1,0,52,0,-52
7654,1,1,82,2581,2499
7655,1,0,56,0,-56
7656,1,0,6,0,-6
7657,1,0,16,0,-16
7658,1,0,137,0,-137
7659,1,1,264,1548,1284
7660,1,1,205,1406,1201
7661,1,1,198,1552,1354
7662,1,1,922,1622,700
7663,1,0,8,0,-8
7664,0,0,65,0,-65
7665,1,0,5,0,-5
7666,0,0,45,0,-45
7667,0,0,179,0,-179
7668,1,1,30,1283,1253
7669,1,0,58,0,-58
7670,0,0,43,0,-43
7671,0,0,6,0,-6
7672,0,0,2,0,-2
7673,1,1,243,1635,1392
7674,1,0,32,0,-32
7675,1,1,280,1321,1041
7676,1,0,20,0,-20
7677,0,0,56,0,-56
7678,1,1,195,1791,1596
7679,1,1,843,1237,394
7680,1,1,437,1232,795
7681,1,1,39,1543,1504
7682,1,1,656,1631,975
7683,1,0,17,0,-17
7684,0,0,76,0,-76
7685,1,0,52,0,-52
7686,0,0,98,0,-98
7687,0,0,89,0,-89
7688,0,0,96,0,-96
7689,1,0,26,0,-26
7690,1,1,168,1397,1229
7691,1,0,5,0,-5
7692,0,0,7,0,-7
7693,1,0,11,0,-11
7694,0,0,3,0,-3
7695,0,0,33,0,-33
7696,0,0,45,0,-45
7697,1,0,51,0,-51
7698,1,0,14,0,-14
7699,1,0,66,0,-66
7700,1,1,820,1418,598
7701,0,0,15,0,-15
7702,1,1,54,1641,1587
7703,1,0,2,0,-2
7704,1,0,44,0,-44
7705,1,0,82,0,-82
7706,1,0,34,0,-34
7707,1,0,48,0,-48
7708,0,0,121,0,-121
7709,1,0,41,0,-41
7710,0,0,3,0,-3
7711,1,0,37,0,-37
7712,1,1,511,1467,956
7713,1,0,2,0,-2
7714,0,0,12,0,-12
7715,0,0,19,0,-19
7716,1,0,21,0,-21
7717,1,0,272,0,-272
7718,0,0,2,0,-2
7719,1,1,383,1276,893
7720,0,0,138,0,-138
7721,0,0,47,0,-47
7722,0,0,65,0,-65
7723,1,0,16,0,-16
7724,1,1,33,1969,1936
7725,1,1,499,1231,732
7726,0,0,3,0,-3
7727,0,0,40,0,-40
7728,0,0,8,0,-8
7729,1,1,1349,1317,-32
7730,0,0,117,0,-117
7731,0,0,243,0,-243
7732,1,0,79,0,-79
7733,1,1,1530,1356,-174
7734,0,0,59,0,-59
7735,0,0,25,0,-25
7736,0,0,26,0,-26
7737,0,0,9,0,-9
7738,1,1,188,1386,1198
7739,0,0,242,0,-242
7740,1,1,367,2288,1921
7741,1,0,33,0,-33
7742,1,0,102,0,-102
7743,1,1,129,1538,1409
7744,1,1,150,1304,1154
7745,0,0,17,0,-17
7746,1,1,424,1278,854
7747,1,1,145,1335,1190
7748,1,1,849,1557,708
7749,1,1,1031,2552,1521
7750,1,1,73,3339,3266
7751,0,0,32,0,-32
7752,0,0,178,0,-178
7753,1,0,18,0,-18
7754,0,0,126,0,-126
7755,1,1,136,1397,1261
7756,1,0,10,0,-10
7757,1,1,334,1452,1118
7758,1,1,304,1395,1091
7759,1,1,517,2261,1744
7760,1,1,468,1644,1176
7761,0,0,6,0,-6
7762,0,0,11,0,-11
7763,1,1,385,1401,1016
7764,1,1,78,1303,1225
7765,0,0,9,0,-9
7766,1,1,215,1504,1289
7767,1,0,17,0,-17
7768,0,0,28,0,-28
7769,0,0,25,0,-25
7770,1,1,86,1242,1156
7771,0,0,254,0,-254
7772,1,1,547,1205,658
7773,0,0,4,0,-4
7774,0,0,86,0,-86
7775,1,0,61,0,-61
7776,1,1,862,1971,1109
7777,1,1,136,1568,1432
7778,1,0,90,0,-90
7779,1,1,306,1659,1353
7780,0,0,177,0,-177
7781,0,0,0,0,0
7782,0,0,9,0,-9
7783,0,0,9,0,-9
7784,0,0,34,0,-34
7785,0,0,9,0,-9
7786,1,1,1272,3298,2026
7787,1,1,187,1888,1701
7788,0,0,29,0,-29
7789,1,1,1023,1859,836
7790,0,0,43,0,-43
7791,1,1,173,1203,1030
7792,0,0,54,0,-54
7793,1,1,28,1270,1242
7794,1,1,284,1851,1567
7795,1,0,20,0,-20
7796,1,1,337,1359,1022
7797,1,0,74,0,-74
7798,1,1,238,1342,1104
7799,0,0,7,0,-7
7800,1,1,99,3037,2938
7801,1,1,16,1872,1856
7802,1,1,588,1202,614
7803,1,1,233,1449,1216
7804,0,0,19,0,-19
7805,0,0,12,0,-12
7806,0,0,6,0,-6
7807,1,1,2234,1799,-435
7808,1,0,205,0,-205
7809,0,0,0,0,0
7810,0,0,12,0,-12
7811,1,0,43,0,-43
7812,1,0,4,0,-4
7813,0,0,54,0,-54
7814,0,0,16,0,-16
7815,1,1,118,1219,1101
7816,1,1,403,2058,1655
7817,1,1,57,1488,1431
7818,0,0,57,0,-57
7819,0,0,17,0,-17
7820,1,1,268,1339,1071
7821,1,0,123,0,-123
7822,0,0,16,0,-16
7823,1,1,229,1249,1020
7824,1,0,16,0,-16
7825,1,0,67,0,-67
7826,0,0,4,0,-4
7827,1,0,5,0,-5
7828,1,1,916,1339,423
7829,0,0,14,0,-14
7830,0,0,29,0,-29
7831,1,1,285,1812,1527
7832,1,1,329,1649,1320
7833,1,1,1489,1579,90
7834,1,0,25,0,-25
7835,1,0,6,0,-6
7836,0,0,36,0,-36
7837,0,0,0,0,0
7838,0,0,40,0,-40
7839,1,0,72,0,-72
7840,0,0,5,0,-5
7841,1,0,93,0,-93
7842,1,1,600,1293,693
7843,1,1,280,2133,1853
7844,0,0,12,0,-12
7845,0,0,25,0,-25
7846,1,0,81,0,-81
7847,1,0,46,0,-46
7848,1,0,29,0,-29
7849,1,1,126,1306,1180
7850,0,0,31,0,-31
7851,1,0,17,0,-17
7852,0,0,3,0,-3
7853,0,0,2,0,-2
7854,1,0,31,0,-31
7855,1,0,139,0,-139
7856,1,0,27,0,-27
7857,0,0,207,0,-207
7858,0,0,340,0,-340
7859,1,0,34,0,-34
7860,1,0,50,0,-50
7861,0,0,78,0,-78
7862,0,0,29,0,-29
7863,1,1,209,2121,1912
7864,1,0,10,0,-10
7865,1,0,41,0,-41
7866,0,0,177,0,-177
7867,1,1,424,1708,1284
7868,0,0,25,0,-25
7869,0,0,59,0,-59
7870,1,0,5,0,-5
7871,0,0,128,0,-128
7872,1,0,0,0,0
7873,0,0,3,0,-3
7874,1,0,63,0,-63
7875,1,1,381,4398,4017
7876,0,0,26,0,-26
7877,1,1,701,1404,703
7878,0,0,13,0,-13
7879,1,1,406,2217,1811
7880,0,0,101,0,-101
7881,1,0,28,0,-28
7882,1,0,50,0,-50
7883,0,0,10,0,-10
7884,0,0,151,0,-151
7885,0,0,103,0,-103
7886,0,0,20,0,-20
7887,1,1,738,1312,574
7888,1,1,259,1531,1272
7889,1,1,313,1559,1246
7890,1,0,336,0,-336
7891,1,1,38,1415,1377
7892,1,1,252,1483,1231
7893,1,1,814,1429,615
7894,1,0,13,0,-13
7895,1,0,23,0,-23
7896,1,1,90,1214,1124
7897,1,1,385,1269,884
7898,0,0,37,0,-37
7899,1,0,37,0,-37
7900,1,1,1095,1535,440
7901,0,0,3,0,-3
7902,0,0,13,0,-13
7903,1,0,31,0,-31
7904,1,1,240,2851,2611
7905,1,0,136,0,-136
7906,0,0,55,0,-55
7907,0,0,13,0,-13
7908,0,0,16,0,-16
7909,0,0,55,0,-55
7910,0,0,91,0,-91
7911,0,0,20,0,-20
7912,1,1,37,1228,1191
7913,1,0,12,0,-12
7914,1,1,392,1620,1228
7915,1,0,38,0,-38
7916,1,0,118,0,-118
7917,1,1,480,1908,1428
7918,0,0,9,0,-9
7919,0,0,189,0,-189
7920,1,1,63,1337,1274
7921,0,0,81,0,-81
7922,1,1,1305,2184,879
7923,0,0,41,0,-41
7924,1,1,466,1987,1521
7925,1,0,11,0,-11
7926,1,1,1994,1362,-632
7927,1,0,11,0,-11
7928,1,0,8,0,-8
7929,1,1,114,1244,1130
7930,1,0,76,0,-76
7931,1,0,32,0,-32
7932,0,0,50,0,-50
7933,0,0,44,0,-44
7934,1,1,1215,1305,90
7935,0,0,29,0,-29
7936,1,0,77,0,-77
7937,1,0,79,0,-79
7938,1,0,21,0,-21
7939,1,0,90,0,-90
7940,1,1,285,1910,1625
7941,1,1,62,1327,1265
7942,1,0,70,0,-70
7943,1,0,54,0,-54
7944,1,0,0,0,0
7945,0,0,141,0,-141
7946,1,1,258,2496,2238
7947,1,0,20,0,-20
7948,0,0,19,0,-19
7949,1,0,8,0,-8
7950,0,0,78,0,-78
7951,1,0,87,0,-87
7952,1,0,108,0,-108
7953,0,0,80,0,-80
7954,1,1,70,1321,1251
7955,1,0,2,0,-2
7956,1,0,19,0,-19
7957,1,1,651,2570,1919
7958,0,0,70,0,-70
7959,1,0,119,0,-119
7960,1,0,55,0,-55
7961,0,0,6,0,-6
7962,1,1,837,1451,614
7963,1,1,399,2463,2064
7964,1,0,17,0,-17
7965,1,0,157,0,-157
7966,0,0,76,0,-76
7967,0,0,91,0,-91
7968,1,1,243,1223,980
7969,0,0,30,0,-30
7970,1,0,26,0,-26
7971,1,1,236,1659,1423
7972,1,0,52,0,-52
7973,0,0,79,0,-79
7974,0,0,13,0,-13
7975,1,0,58,0,-58
7976,0,0,6,0,-6
7977,1,0,6,0,-6
7978,0,0,14,0,-14
7979,1,0,41,0,-41
7980,0,0,38,0,-38
7981,0,0,43,0,-43
7982,1,0,58,0,-58
7983,1,0,52,0,-52
7984,0,0,81,0,-81
7985,1,0,66,0,-66
7986,1,0,84,0,-84
7987,0,0,35,0,-35
7988,0,0,35,0,-35
7989,0,0,142,0,-142
7990,1,1,338,1666,1328
7991,1,1,1443,1782,339
7992,0,0,10,0,-10
7993,1,1,102,1278,1176
7994,1,0,44,0,-44
7995,1,0,74,0,-74
7996,1,0,253,0,-253
7997,1,0,8,0,-8
7998,0,0,34,0,-34
7999,1,0,21,0,-21
8000,1,1,340,1282,942
8001,1,0,17,0,-17
8002,1,0,48,0,-48
8003,0,0,41,0,-41
8004,0,0,37,0,-37
8005,1,0,34,0,-34
8006,1,0,3,0,-3
8007,1,0,64,0,-64
8008,0,0,19,0,-19
8009,1,0,15,0,-15
8010,1,1,1345,1742,397
8011,0,0,33,0,-33
8012,0,0,12,0,-12
8013,1,1,323,1214,891
8014,0,0,9,0,-9
8015,1,0,5,0,-5
8016,1,1,257,1358,1101
8017,1,1,180,4985,4805
8018,0,0,72,0,-72
8019,0,0,55,0,-55
8020,0,0,52,0,-52
8021,1,1,304,2734,2430
8022,1,1,1474,2340,866
8023,1,1,2326,1265,-1061
8024,1,1,921,1232,311
8025,1,0,23,0,-23
8026,0,0,110,0,-110
8027,1,1,98,1340,1242
8028,0,0,96,0,-96
8029,1,0,33,0,-33
8030,0,0,31,0,-31
8031,1,0,13,0,-13
8032,1,0,27,0,-27
8033,1,1,385,1532,1147
8034,1,1,149,1288,1139
8035,1,1,28,2074,2046
8036,1,0,31,0,-31
8037,0,0,8,0,-8
8038,0,0,125,0,-125
8039,1,0,36,0,-36
8040,1,1,397,1308,911
8041,0,0,8,0,-8
8042,1,1,172,1296,1124
8043,1,1,1630,1215,-415
8044,1,0,29,0,-29
8045,1,0,20,0,-20
8046,1,0,9,0,-9
8047,0,0,7,0,-7
8048,1,1,152,1478,1326
8049,1,1,297,1412,1115
8050,1,0,1,0,-1
8051,0,0,6,0,-6
8052,0,0,15,0,-15
8053,0,0,5,0,-5
8054,0,0,89,0,-89
8055,1,0,32,0,-32
8056,1,1,447,1467,1020
8057,0,0,70,0,-70
8058,1,0,31,0,-31
8059,1,0,34,0,-34
8060,1,0,10,0,-10
8061,1,0,23,0,-23
8062,1,1,421,1371,950
8063,0,0,15,0,-15
8064,0,0,48,0,-48
8065,1,0,22,0,-22
8066,1,0,70,0,-70
8067,0,0,26,0,-26
8068,1,0,27,0,-27
8069,0,0,12,0,-12
8070,1,1,897,1702,805
8071,0,0,36,0,-36
8072,1,0,17,0,-17
8073,1,0,8,0,-8
8074,1,0,1,0,-1
8075,1,1,378,1627,1249
8076,1,0,77,0,-77
8077,1,1,400,1364,964
8078,0,0,3,0,-3
8079,1,0,20,0,-20
8080,0,0,46,0,-46
8081,1,1,937,1226,289
8082,0,0,28,0,-28
8083,0,0,33,0,-33
8084,1,0,29,0,-29
8085,1,1,162,1532,1370
8086,1,1,1334,2589,1255
8087,0,0,35,0,-35
8088,1,1,223,1236,1013
8089,1,0,33,0,-33
8090,1,1,1221,5494,4273
8091,0,0,65,0,-65
8092,1,0,82,0,-82
8093,0,0,42,0,-42
8094,0,0,165,0,-165
8095,1,1,19,1812,1793
8096,1,1,655,1251,596
8097,0,0,75,0,-75
8098,1,1,414,1281,867
8099,1,1,528,1226,698
8100,0,0,59,0,-59
8101,0,0,7,0,-7
8102,0,0,20,0,-20
8103,1,0,40,0,-40
8104,0,0,4,0,-4
8105,1,1,341,1414,1073
8106,1,0,30,0,-30
8107,1,0,9,0,-9
8108,1,1,799,1308,509
8109,0,0,40,0,-40
8110,1,0,8,0,-8
8111,1,0,26,0,-26
8112,0,0,141,0,-141
8113,1,0,29,0,-29
8114,0,0,66,0,-66
8115,0,0,30,0,-30
8116,1,1,196,2810,2614
8117,0,0,19,0,-19
8118,1,0,49,0,-49
8119,0,0,94,0,-94
8120,1,1,311,1301,990
8121,1,0,28,0,-28
8122,1,0,29,0,-29
8123,0,0,201,0,-201
8124,1,1,382,1338,956
8125,1,0,40,0,-40
8126,0,0,181,0,-181
8127,0,0,9,0,-9
8128,1,1,141,1501,1360
8129,0,0,73,0,-73
8130,0,0,6,0,-6
8131,0,0,70,0,-70
8132,1,0,7,0,-7
8133,1,1,208,1797,1589
8134,1,1,53,1414,1361
8135,0,0,20,0,-20
8136,1,0,14,0,-14
8137,0,0,14,0,-14
8138,1,1,589,1239,650
8139,0,0,4,0,-4
8140,0,0,43,0,-43
8141,0,0,111,0,-111
8142,0,0,44,0,-44
8143,0,0,65,0,-65
8144,0,0,169,0,-169
8145,1,1,654,1326,672
8146,1,1,541,1225,684
8147,1,0,8,0,-8
8148,1,0,11,0,-11
8149,1,1,1132,1392,260
8150,1,1,420,1303,883
8151,0,0,71,0,-71
8152,1,0,122,0,-122
8153,0,0,54,0,-54
8154,0,0,68,0,-68
8155,1,0,16,0,-16
8156,1,0,26,0,-26
8157,0,0,27,0,-27
8158,0,0,99,0,-99
8159,0,0,2,0,-2
8160,1,1,247,1251,1004
8161,1,0,60,0,-60
8162,1,0,114,0,-114
8163,1,1,259,1448,1189
8164,1,0,47,0,-47
8165,0,0,0,0,0
8166,1,0,9,0,-9
8167,0,0,115,0,-115
8168,1,0,136,0,-136
8169,0,0,62,0,-62
8170,0,0,19,0,-19
8171,1,0,50,0,-50
8172,1,0,62,0,-62
8173,1,1,454,2007,1553
8174,0,0,45,0,-45
8175,1,0,99,0,-99
8176,0,0,41,0,-41
8177,0,0,3,0,-3
8178,0,0,86,0,-86
8179,1,1,147,1251,1104
8180,0,0,53,0,-53
8181,1,1,1221,1862,641
8182,1,1,16,1342,1326
8183,1,1,1508,1627,119
8184,1,0,30,0,-30
8185,1,0,95,0,-95
8186,0,0,64,0,-64
8187,1,0,39,0,-39
8188,0,0,1,0,-1
8189,1,1,891,1433,542
8190,0,0,21,0,-21
8191,0,0,31,0,-31
8192,1,1,535,1551,1016
8193,1,1,63,2626,2563
8194,0,0,36,0,-36
8195,1,1,146,1971,1825
8196,1,0,136,0,-136
8197,1,1,589,1231,642
8198,0,0,31,0,-31
8199,1,1,842,1417,575
8200,0,0,42,0,-42
8201,1,0,2,0,-2
8202,1,0,54,0,-54
8203,0,0,26,0,-26
8204,1,1,93,2270,2177
8205,0,0,26,0,-26
8206,0,0,25,0,-25
8207,1,1,256,1529,1273
8208,1,0,199,0,-199
8209,1,0,64,0,-64
8210,0,0,53,0,-53
8211,0,0,26,0,-26
8212,1,1,343,1238,895
8213,0,0,10,0,-10
8214,1,0,66,0,-66
8215,1,0,148,0,-148
8216,1,1,122,1545,1423
8217,1,1,658,1439,781
8218,1,1,615,1330,715
8219,1,0,39,0,-39
8220,0,0,106,0,-106
8221,0,0,26,0,-26
8222,1,1,411,1252,841
8223,0,0,91,0,-91
8224,0,0,70,0,-70
8225,0,0,178,0,-178
8226,1,1,292,1424,1132
8227,0,0,399,0,-399
8228,1,1,91,1456,1365
8229,0,0,11,0,-11
8230,1,0,17,0,-17
8231,0,0,53,0,-53
8232,1,0,9,0,-9
8233,1,1,424,1650,1226
8234,0,0,15,0,-15
8235,1,0,7,0,-7
8236,1,1,266,1200,934
8237,0,0,23,0,-23
8238,1,1,1399,1638,239
8239,1,1,710,2774,2064
8240,1,0,58,0,-58
8241,1,0,8,0,-8
8242,1,1,284,1385,1101
8243,1,0,78,0,-78
8244,1,0,13,0,-13
8245,0,0,19,0,-19
8246,0,0,62,0,-62
8247,0,0,15,0,-15
8248,1,1,239,1385,1146
8249,1,1,364,1856,1492
8250,1,0,39,0,-39
8251,1,0,23,0,-23
8252,0,0,24,0,-24
8253,0,0,44,0,-44
8254,0,0,16,0,-16
8255,0,0,17,0,-17
8256,0,0,12,0,-12
8257,0,0,20,0,-20
8258,1,1,120,2470,2350
8259,1,1,1820,1400,-420
8260,1,1,59,1319,1260
8261,0,0,55,0,-55
8262,1,1,38,1920,1882
8263,1,0,33,0,-33
8264,1,1,94,2209,2115
8265,0,0,102,0,-102
8266,0,0,122,0,-122
8267,0,0,18,0,-18
8268,0,0,34,0,-34
8269,1,0,30,0,-30
8270,0,0,8,0,-8
8271,1,0,32,0,-32
8272,1,1,654,1700,1046
8273,0,0,61,0,-61
8274,1,1,898,1266,368
8275,0,0,30,0,-30
8276,1,0,0,0,0
8277,0,0,37,0,-37
8278,0,0,14,0,-14
8279,0,0,52,0,-52
8280,0,0,62,0,-62
8281,1,1,363,1663,1300
8282,1,0,117,0,-117
8283,1,0,173,0,-173
8284,1,1,146,1397,1251
8285,1,0,51,0,-51
8286,1,1,182,1292,1110
8287,1,0,136,0,-136
8288,0,0,6,0,-6
8289,1,1,422,1481,1059
8290,1,0,10,0,-10
8291,0,0,37,0,-37
8292,0,0,43,0,-43
8293,1,0,49,0,-49
8294,1,0,3,0,-3
8295,1,1,79,1593,1514
8296,1,0,15,0,-15
8297,1,1,676,1327,651
8298,1,0,21,0,-21
8299,0,0,79,0,-79
8300,0,0,22,0,-22
8301,1,0,83,0,-83
8302,0,0,95,0,-95
8303,0,0,48,0,-48
8304,1,0,94,0,-94
8305,0,0,98,0,-98
8306,1,0,27,0,-27
8307,1,1,73,1635,1562
8308,0,0,10,0,-10
8309,1,0,109,0,-109
8310,0,0,99,0,-99
8311,0,0,51,0,-51
8312,1,1,92,1272,1180
8313,1,1,82,1256,1174
8314,0,0,27,0,-27
8315,0,0,88,0,-88
8316,1,1,152,1204,1052
8317,0,0,7,0,-7
8318,1,0,21,0,-21
8319,0,0,78,0,-78
8320,0,0,14,0,-14
8321,1,0,50,0,-50
8322,0,0,60,0,-60
8323,0,0,119,0,-119
8324,0,0,16,0,-16
8325,1,1,164,1439,1275
8326,1,0,51,0,-51
8327,1,1,1470,1335,-135
8328,1,1,812,1266,454
8329,1,0,41,0,-41
8330,1,1,677,1519,842
8331,0,0,13,0,-13
8332,1,0,8,0,-8
8333,1,1,1224,1252,28
8334,1,1,874,1247,373
8335,1,1,952,1262,310
8336,0,0,61,0,-61
8337,1,1,846,1335,489
8338,1,1,534,1622,1088
8339,1,1,74,4343,4269
8340,1,0,17,0,-17
8341,1,0,1,0,-1
8342,0,0,73,0,-73
8343,1,1,122,1732,1610
8344,0,0,1,0,-1
8345,1,0,62,0,-62
8346,1,1,69,1231,1162
8347,0,0,22,0,-22
8348,0,0,42,0,-42
8349,1,1,924,1218,294
8350,1,1,580,1310,730
8351,1,1,627,1240,613
8352,0,0,96,0,-96
8353,1,0,160,0,-160
8354,1,0,108,0,-108
8355,1,1,81,1663,1582
8356,0,0,34,0,-34
8357,0,0,66,0,-66
8358,0,0,14,0,-14
8359,1,1,508,1650,1142
8360,1,0,0,0,0
8361,0,0,128,0,-128
8362,1,0,66,0,-66
8363,0,0,22,0,-22
8364,1,0,48,0,-48
8365,0,0,231,0,-231
8366,0,0,84,0,-84
8367,1,0,33,0,-33
8368,1,0,75,0,-75
8369,1,1,1043,2392,1349
8370,0,0,32,0,-32
8371,0,0,171,0,-171
8372,0,0,11,0,-11
8373,0,0,27,0,-27
8374,0,0,26,0,-26
8375,0,0,21,0,-21
8376,0,0,25,0,-25
8377,0,0,29,0,-29
8378,0,0,102,0,-102
8379,1,1,208,2772,2564
8380,1,1,780,1258,478
8381,1,0,65,0,-65
8382,1,0,1,0,-1
8383,0,0,77,0,-77
8384,1,1,529,1740,1211
8385,1,1,54,1521,1467
8386,1,0,47,0,-47
8387,1,0,186,0,-186
8388,1,1,47,1364,1317
8389,1,1,613,1275,662
8390,1,0,2,0,-2
8391,0,0,30,0,-30
8392,0,0,48,0,-48
8393,1,1,670,1445,775
8394,0,0,88,0,-88
8395,0,0,111,0,-111
8396,1,1,932,1357,425
8397,1,0,7,0,-7
8398,1,1,59,1262,1203
8399,1,1,1146,1327,181
8400,0,0,42,0,-42
8401,0,0,34,0,-34
8402,1,0,58,0,-58
8403,0,0,13,0,-13
8404,0,0,65,0,-65
8405,1,1,75,1606,1531
8406,1,0,12,0,-12
8407,1,1,272,1222,950
8408,1,0,131,0,-131
8409,0,0,16,0,-16
8410,1,1,202,1715,1513
8411,1,0,36,0,-36
8412,0,0,39,0,-39
8413,0,0,59,0,-59
8414,0,0,50,0,-50
8415,1,0,41,0,-41
8416,0,0,35,0,-35
8417,0,0,1,0,-1
8418,1,1,1802,1228,-574
8419,0,0,132,0,-132
8420,0,0,5,0,-5
8421,1,1,192,1875,1683
8422,0,0,1,0,-1
8423,1,1,806,1333,527
8424,1,1,30,1408,1378
8425,1,1,380,1204,824
8426,1,0,217,0,-217
8427,0,0,13,0,-13
8428,1,0,28,0,-28
8429,1,0,185,0,-185
8430,1,0,47,0,-47
8431,0,0,45,0,-45
8432,1,0,3,0,-3
8433,1,1,127,1632,1505
8434,1,1,540,1211,671
8435,0,0,55,0,-55
8436,1,1,742,1229,487
8437,0,0,53,0,-53
8438,1,1,801,1216,415
8439,0,0,123,0,-123
8440,1,1,394,1494,1100
8441,0,0,71,0,-71
8442,1,1,1375,3516,2141
8443,1,1,1780,1672,-108
8444,1,0,22,0,-22
8445,1,1,1065,1247,182
8446,1,0,1,0,-1
8447,0,0,125,0,-125
8448,1,0,9,0,-9
8449,0,0,29,0,-29
8450,1,1,276,1281,1005
8451,1,1,250,1601,1351
8452,1,1,148,1333,1185
8453,0,0,0,0,0
8454,0,0,130,0,-130
8455,1,1,316,1640,1324
8456,1,1,242,1431,1189
8457,1,1,532,3461,2929
8458,1,1,191,1549,1358
8459,1,1,365,1509,1144
8460,1,0,12,0,-12
8461,1,0,115,0,-115
8462,1,0,61,0,-61
8463,1,0,4,0,-4
8464,0,0,17,0,-17
8465,1,1,1321,1214,-107
8466,0,0,8,0,-8
8467,0,0,18,0,-18
8468,1,0,0,0,0
8469,1,1,1026,1635,609
8470,1,0,51,0,-51
8471,1,1,205,1517,1312
8472,1,1,137,1296,1159
8473,0,0,5,0,-5
8474,0,0,15,0,-15
8475,1,0,31,0,-31
8476,0,0,33,0,-33
8477,0,0,128,0,-128
8478,0,0,18,0,-18
8479,0,0,11,0,-11
8480,0,0,4,0,-4
8481,0,0,12,0,-12
8482,0,0,30,0,-30
8483,1,0,88,0,-88
8484,0,0,9,0,-9
8485,0,0,13,0,-13
8486,0,0,112,0,-112
8487,1,0,4,0,-4
8488,0,0,111,0,-111
8489,1,0,4,0,-4
8490,1,1,341,1277,936
8491,1,0,152,0,-152
8492,1,0,42,0,-42
8493,0,0,101,0,-101
8494,1,1,689,1443,754
8495,1,0,14,0,-14
8496,1,1,1097,1386,289
8497,0,0,1,0,-1
8498,0,0,15,0,-15
8499,0,0,12,0,-12
8500,1,1,110,1255,1145
8501,0,0,33,0,-33
8502,0,0,119,0,-119
8503,1,1,1165,2143,978
8504,1,1,248,2048,1800
8505,1,1,255,1205,950
8506,0,0,4,0,-4
8507,0,0,2,0,-2
8508,1,0,0,0,0
8509,1,0,1,0,-1
8510,1,1,56,1238,1182
8511,1,1,760,1277,517
8512,0,0,13,0,-13
8513,1,0,1,0,-1
8514,0,0,36,0,-36
8515,0,0,69,0,-69
8516,0,0,75,0,-75
8517,1,1,179,1750,1571
8518,0,0,7,0,-7
8519,0,0,118,0,-118
8520,0,0,93,0,-93
8521,1,1,1503,2414,911
8522,0,0,92,0,-92
8523,1,1,517,1212,695
8524,0,0,4,0,-4
8525,1,0,113,0,-113
8526,1,0,65,0,-65
8527,1,1,351,1427,1076
8528,0,0,22,0,-22
8529,1,1,404,1345,941
8530,1,0,83,0,-83
8531,1,0,57,0,-57
8532,1,1,977,1353,376
8533,1,1,59,1727,1668
8534,1,1,689,1714,1025
8535,0,0,17,0,-17
8536,1,1,565,1289,724
8537,1,0,31,0,-31
8538,1,1,75,1348,1273
8539,0,0,69,0,-69
8540,0,0,10,0,-10
8541,1,1,234,1288,1054
8542,0,0,47,0,-47
8543,1,1,389,1204,815
8544,1,0,242,0,-242
8545,1,0,171,0,-171
8546,0,0,49,0,-49
8547,1,1,523,1563,1040
8548,1,1,112,1616,1504
8549,0,0,5,0,-5
8550,0,0,77,0,-77
8551,0,0,83,0,-83
8552,1,1,156,1477,1321
8553,0,0,25,0,-25
8554,1,1,484,1447,963
8555,1,0,90,0,-90
8556,1,0,61,0,-61
8557,1,0,123,0,-123
8558,1,0,7,0,-7
8559,1,0,103,0,-103
8560,1,0,13,0,-13
8561,1,1,276,1456,1180
8562,1,0,34,0,-34
8563,1,0,11,0,-11
8564,0,0,85,0,-85
8565,0,0,75,0,-75
8566,0,0,1,0,-1
8567,0,0,42,0,-42
8568,0,0,3,0,-3
8569,0,0,10,0,-10
8570,1,0,135,0,-135
8571,1,0,1,0,-1
8572,1,1,227,1966,1739
8573,0,0,41,0,-41
8574,1,0,69,0,-69
8575,0,0,0,0,0
8576,0,0,101,0,-101
8577,1,0,53,0,-53
8578,1,0,9,0,-9
8579,1,0,124,0,-124
8580,1,0,40,0,-40
8581,1,0,89,0,-89
8582,1,1,271,1439,1168
8583,0,0,17,0,-17
8584,1,0,24,0,-24
8585,1,1,585,1713,1128
8586,1,1,44,1205,1161
8587,1,1,131,4463,4332
8588,1,1,319,1260,941
8589,1,0,115,0,-115
8590,0,0,63,0,-63
8591,0,0,28,0,-28
8592,1,1,697,2359,1662
8593,1,1,496,1210,714
8594,1,1,270,1377,1107
8595,1,0,20,0,-20
8596,1,0,126,0,-126
8597,1,0,2,0,-2
8598,0,0,7,0,-7
8599,0,0,44,0,-44
8600,0,0,44,0,-44
8601,0,0,0,0,0
8602,1,1,618,1721,1103
8603,1,1,1464,1301,-163
8604,0,0,20,0,-20
8605,0,0,41,0,-41
8606,1,1,2124,1337,-787
8607,0,0,7,0,-7
8608,0,0,37,0,-37
8609,1,1,493,1522,1029
8610,1,1,68,1361,1293
8611,0,0,182,0,-182
8612,0,0,39,0,-39
8613,1,1,140,1532,1392
8614,0,0,11,0,-11
8615,1,1,132,4810,4678
8616,0,0,193,0,-193
8617,1,0,173,0,-173
8618,1,1,955,1394,439
8619,1,0,44,0,-44
8620,1,0,18,0,-18
8621,0,0,156,0,-156
8622,0,0,5,0,-5
8623,1,1,518,2060,1542
8624,0,0,5,0,-5
8625,1,0,94,0,-94
8626,0,0,10,0,-10
8627,1,0,7,0,-7
8628,1,1,143,2557,2414
8629,1,1,589,1539,950
8630,1,0,19,0,-19
8631,1,0,27,0,-27
8632,1,0,98,0,-98
8633,1,0,144,0,-144
8634,0,0,4,0,-4
8635,0,0,30,0,-30
8636,0,0,67,0,-67
8637,1,1,689,1779,1090
8638,1,1,1744,1232,-512
8639,0,0,51,0,-51
8640,1,1,203,1507,1304
8641,0,0,179,0,-179
8642,1,0,1,0,-1
8643,0,0,4,0,-4
8644,0,0,38,0,-38
8645,1,0,1,0,-1
8646,0,0,13,0,-13
8647,1,0,25,0,-25
8648,1,0,12,0,-12
8649,1,1,1902,1521,-381
8650,1,1,1084,1285,201
8651,1,1,414,1236,822
8652,0,0,3,0,-3
8653,1,0,25,0,-25
8654,0,0,90,0,-90
8655,1,0,84,0,-84
8656,1,1,299,1395,1096
8657,0,0,28,0,-28
8658,1,1,329,1258,929
8659,1,0,80,0,-80
8660,1,1,1201,1903,702
8661,1,1,303,1309,1006
8662,0,0,7,0,-7
8663,0,0,21,0,-21
8664,0,0,34,0,-34
8665,1,0,50,0,-50
8666,1,1,1121,1305,184
8667,0,0,34,0,-34
8668,1,1,91,1391,1300
8669,1,1,226,1415,1189
8670,1,1,137,2315,2178
8671,0,0,45,0,-45
8672,1,0,0,0,0
8673,0,0,1,0,-1
8674,0,0,73,0,-73
8675,1,1,334,1384,1050
8676,1,1,1011,1792,781
8677,0,0,9,0,-9
8678,0,0,9,0,-9
8679,1,0,5,0,-5
8680,0,0,10,0,-10
8681,1,1,335,1715,1380
8682,1,0,109,0,-109
8683,1,0,15,0,-15
8684,1,0,16,0,-16
8685,1,0,103,0,-103
8686,1,0,8,0,-8
8687,1,0,37,0,-37
8688,1,1,31,1408,1377
8689,1,1,279,1577,1298
8690,1,0,12,0,-12
8691,1,1,298,1349,1051
8692,1,0,44,0,-44
8693,1,0,45,0,-45
8694,1,0,5,0,-5
8695,1,1,914,2537,1623
8696,1,1,278,1302,1024
8697,1,1,361,1274,913
8698,0,0,7,0,-7
8699,1,1,959,1488,529
8700,0,0,77,0,-77
8701,1,1,1113,1381,268
8702,1,1,1366,2587,1221
8703,0,0,38,0,-38
8704,0,0,43,0,-43
8705,1,1,57,1550,1493
8706,1,0,21,0,-21
8707,1,1,550,2310,1760
8708,0,0,235,0,-235
8709,0,0,39,0,-39
8710,1,0,17,0,-17
8711,0,0,68,0,-68
8712,0,0,23,0,-23
8713,0,0,51,0,-51
8714,0,0,43,0,-43
8715,1,1,125,1370,1245
8716,0,0,15,0,-15
8717,0,0,24,0,-24
8718,0,0,63,0,-63
8719,0,0,140,0,-140
8720,1,0,43,0,-43
8721,1,1,325,1728,1403
8722,1,0,10,0,-10
8723,1,1,46,1796,1750
8724,0,0,23,0,-23
8725,1,1,473,1357,884
8726,1,0,4,0,-4
8727,1,1,670,1502,832
8728,1,0,32,0,-32
8729,1,1,912,1623,711
8730,1,0,28,0,-28
8731,0,0,16,0,-16
8732,0,0,92,0,-92
8733,0,0,16,0,-16
8734,1,0,3,0,-3
8735,0,0,30,0,-30
8736,1,1,775,1629,854
8737,0,0,60,0,-60
8738,0,0,1,0,-1
8739,1,0,4,0,-4
8740,1,0,1,0,-1
8741,1,1,597,1274,677
8742,1,0,15,0,-15
8743,1,1,814,2059,1245
8744,1,1,277,1387,1110
8745,1,1,654,2656,2002
8746,1,1,184,1217,1033
8747,0,0,231,0,-231
8748,1,0,0,0,0
8749,1,1,1070,1373,303
8750,0,0,9,0,-9
8751,1,0,10,0,-10
8752,0,0,9,0,-9
8753,1,0,1,0,-1
8754,1,0,24,0,-24
8755,1,1,442,1893,1451
8756,0,0,180,0,-180
8757,1,0,32,0,-32
8758,0,0,7,0,-7
8759,0,0,78,0,-78
8760,0,0,36,0,-36
8761,1,1,859,1354,495
8762,0,0,15,0,-15
8763,0,0,0,0,0
8764,1,1,363,1608,1245
8765,0,0,72,0,-72
8766,0,0,63,0,-63
8767,1,0,11,0,-11
8768,0,0,10,0,-10
8769,0,0,44,0,-44
8770,1,0,51,0,-51
8771,1,0,26,0,-26
8772,0,0,7,0,-7
8773,1,1,2876,1466,-1410
8774,0,0,12,0,-12
8775,0,0,62,0,-62
8776,1,0,15,0,-15
8777,1,0,33,0,-33
8778,1,0,8,0,-8
8779,0,0,78,0,-78
8780,0,0,103,0,-103
8781,1,1,182,4883,4701
8782,1,0,12,0,-12
8783,1,0,37,0,-37
8784,0,0,2,0,-2
8785,0,0,51,0,-51
8786,0,0,17,0,-17
8787,0,0,61,0,-61
8788,1,1,411,1263,852
8789,1,0,45,0,-45
8790,1,0,13,0,-13
8791,1,0,23,0,-23
8792,0,0,35,0,-35
8793,1,1,1780,1258,-522
8794,1,1,108,1452,1344
8795,0,0,86,0,-86
8796,1,1,103,1553,1450
8797,0,0,81,0,-81
8798,1,0,45,0,-45
8799,0,0,22,0,-22
8800,0,0,88,0,-88
8801,0,0,13,0,-13
8802,1,1,109,1819,1710
8803,1,0,92,0,-92
8804,0,0,51,0,-51
8805,0,0,6,0,-6
8806,1,0,5,0,-5
8807,0,0,117,0,-117
8808,1,1,479,1487,1008
8809,1,1,1776,1225,-551
8810,0,0,16,0,-16
8811,1,0,63,0,-63
8812,1,0,75,0,-75
8813,1,1,29,1240,1211
8814,1,0,3,0,-3
8815,1,0,2,0,-2
8816,1,0,10,0,-10
8817,0,0,37,0,-37
8818,0,0,65,0,-65
8819,1,1,476,1516,1040
8820,0,0,92,0,-92
8821,1,0,14,0,-14
8822,0,0,1,0,-1
8823,0,0,11,0,-11
8824,1,0,0,0,0
8825,1,1,625,1865,1240
8826,0,0,64,0,-64
8827,0,0,41,0,-41
8828,0,0,6,0,-6
8829,1,0,3,0,-3
8830,1,0,73,0,-73
8831,0,0,14,0,-14
8832,1,1,1106,1593,487
8833,1,0,4,0,-4
8834,0,0,20,0,-20
8835,1,1,508,1292,784
8836,0,0,39,0,-39
8837,1,1,995,1665,670
8838,1,1,1309,1586,277
8839,1,0,16,0,-16
8840,1,1,114,1790,1676
8841,0,0,50,0,-50
8842,1,1,273,1217,944
8843,1,1,578,2688,2110
8844,0,0,79,0,-79
8845,0,0,84,0,-84
8846,1,0,10,0,-10
8847,0,0,5,0,-5
8848,0,0,44,0,-44
8849,1,0,90,0,-90
8850,0,0,62,0,-62
8851,0,0,4,0,-4
8852,0,0,44,0,-44
8853,0,0,18,0,-18
8854,1,1,1128,1326,198
8855,1,0,59,0,-59
8856,1,1,566,1237,671
8857,0,0,13,0,-13
8858,1,0,19,0,-19
8859,1,0,44,0,-44
8860,1,1,329,1435,1106
8861,1,0,131,0,-131
8862,1,1,388,1222,834
8863,0,0,11,0,-11
8864,1,0,69,0,-69
8865,1,0,1,0,-1
8866,0,0,42,0,-42
8867,0,0,140,0,-140
8868,0,0,124,0,-124
8869,1,0,8,0,-8
8870,0,0,39,0,-39
8871,1,0,3,0,-3
8872,0,0,140,0,-140
8873,1,1,1214,2364,1150
8874,1,1,476,1267,791
8875,0,0,139,0,-139
8876,1,1,847,1472,625
8877,0,0,192,0,-192
8878,1,1,263,1436,1173
8879,0,0,31,0,-31
8880,0,0,76,0,-76
8881,1,0,45,0,-45
8882,1,1,78,1535,1457
8883,0,0,43,0,-43
8884,0,0,35,0,-35
8885,1,1,411,1317,906
8886,1,1,67,1469,1402
8887,0,0,54,0,-54
8888,0,0,72,0,-72
8889,0,0,9,0,-9
8890,1,0,31,0,-31
8891,0,0,17,0,-17
8892,0,0,41,0,-41
8893,1,0,72,0,-72
8894,0,0,45,0,-45
8895,1,1,313,1786,1473
8896,1,0,85,0,-85
8897,0,0,7,0,-7
8898,1,0,67,0,-67
8899,1,1,604,1507,903
8900,1,1,148,1616,1468
8901,0,0,39,0,-39
8902,1,0,60,0,-60
8903,0,0,4,0,-4
8904,0,0,16,0,-16
8905,1,0,23,0,-23
8906,1,1,173,1434,1261
8907,1,1,152,1240,1088
8908,1,0,16,0,-16
8909,1,0,28,0,-28
8910,1,0,2,0,-2
8911,1,1,289,1352,1063
8912,1,1,129,1447,1318
8913,0,0,1,0,-1
8914,0,0,52,0,-52
8915,1,1,653,1208,555
8916,1,0,49,0,-49
8917,1,1,85,1572,1487
8918,0,0,123,0,-123
8919,0,0,116,0,-116
8920,1,1,272,1410,1138
8921,0,0,7,0,-7
8922,1,0,219,0,-219
8923,1,1,220,1215,995
8924,0,0,18,0,-18
8925,0,0,31,0,-31
8926,0,0,8,0,-8
8927,0,0,32,0,-32
8928,0,0,20,0,-20
8929,1,0,51,0,-51
8930,1,1,179,1220,1041
8931,0,0,33,0,-33
8932,1,1,1062,1379,317
8933,1,0,67,0,-67
8934,0,0,40,0,-40
8935,1,0,38,0,-38
8936,0,0,4,0,-4
8937,1,1,449,1599,1150
8938,1,1,527,1352,825
8939,1,1,189,1394,1205
8940,0,0,99,0,-99
8941,1,1,861,1262,401
8942,0,0,51,0,-51
8943,0,0,4,0,-4
8944,0,0,6,0,-6
8945,0,0,68,0,-68
8946,1,1,993,1234,241
8947,0,0,76,0,-76
8948,0,0,2,0,-2
8949,0,0,14,0,-14
8950,0,0,69,0,-69
8951,1,0,5,0,-5
8952,1,0,56,0,-56
8953,1,1,1480,1249,-231
8954,1,1,1175,1325,150
8955,0,0,18,0,-18
8956,0,0,23,0,-23
8957,0,0,5,0,-5
8958,0,0,80,0,-80
8959,1,1,220,1209,989
8960,0,0,2,0,-2
8961,1,1,1236,1202,-34
8962,1,0,104,0,-104
8963,1,0,88,0,-88
8964,1,1,128,1513,1385
8965,1,0,53,0,-53
8966,1,0,114,0,-114
8967,1,1,309,1398,1089
8968,0,0,3,0,-3
8969,0,0,29,0,-29
8970,0,0,6,0,-6
8971,0,0,49,0,-49
8972,1,1,584,1848,1264
8973,1,0,14,0,-14
8974,0,0,5,0,-5
8975,0,0,6,0,-6
8976,0,0,18,0,-18
8977,0,0,9,0,-9
8978,1,1,1583,1301,-282
8979,1,1,56,1908,1852
8980,1,0,27,0,-27
8981,1,0,55,0,-55
8982,0,0,37,0,-37
8983,0,0,18,0,-18
8984,1,1,103,1574,1471
8985,1,0,22,0,-22
8986,1,0,3,0,-3
8987,1,0,13,0,-13
8988,1,1,386,1238,852
8989,1,0,69,0,-69
8990,0,0,15,0,-15
8991,0,0,11,0,-11
8992,1,0,74,0,-74
8993,0,0,49,0,-49
8994,0,0,61,0,-61
8995,1,0,44,0,-44
8996,1,1,479,1759,1280
8997,0,0,0,0,0
8998,1,1,777,2448,1671
8999,0,0,80,0,-80
9000,1,0,208,0,-208
9001,1,1,38,1500,1462
9002,1,0,63,0,-63
9003,1,0,26,0,-26
9004,0,0,9,0,-9
9005,1,0,120,0,-120
9006,1,0,29,0,-29
9007,0,0,48,0,-48
9008,1,1,166,2149,1983
9009,0,0,5,0,-5
9010,1,0,141,0,-141
9011,1,0,107,0,-107
9012,1,1,214,1216,1002
9013,1,0,0,0,0
9014,1,1,1070,1974,904
9015,0,0,4,0,-4
9016,1,1,175,1804,1629
9017,1,1,761,1426,665
9018,1,0,157,0,-157
9019,0,0,45,0,-45
9020,1,1,547,1269,722
9021,1,0,188,0,-188
9022,1,1,408,1421,1013
9023,0,0,53,0,-53
9024,1,1,861,1250,389
9025,0,0,27,0,-27
9026,1,1,46,1430,1384
9027,1,1,70,1208,1138
9028,1,0,89,0,-89
9029,1,1,126,1783,1657
9030,0,0,44,0,-44
9031,1,0,52,0,-52
9032,0,0,140,0,-140
9033,0,0,7,0,-7
9034,0,0,127,0,-127
9035,0,0,1,0,-1
9036,0,0,102,0,-102
9037,1,1,289,1568,1279
9038,1,0,2,0,-2
9039,1,0,30,0,-30
9040,1,1,836,1484,648
9041,1,0,2,0,-2
9042,1,0,17,0,-17
9043,1,0,41,0,-41
9044,1,0,0,0,0
9045,1,0,16,0,-16
9046,1,1,1028,1449,421
9047,0,0,7,0,-7
9048,1,0,22,0,-22
9049,1,0,138,0,-138
9050,1,1,342,1586,1244
9051,1,1,83,1614,1531
9052,0,0,38,0,-38
9053,1,1,744,3523,2779
9054,0,0,16,0,-16
9055,1,1,462,1401,939
9056,1,0,25,0,-25
9057,0,0,50,0,-50
9058,0,0,90,0,-90
9059,1,1,353,3116,2763
9060,1,0,109,0,-109
9061,0,0,9,0,-9
9062,1,1,72,1405,1333
9063,1,0,163,0,-163
9064,1,0,5,0,-5
9065,0,0,45,0,-45
9066,0,0,78,0,-78
9067,1,1,166,1327,1161
9068,0,0,51,0,-51
9069,1,0,20,0,-20
9070,0,0,76,0,-76
9071,1,1,252,1679,1427
9072,1,1,1095,1579,484
9073,0,0,86,0,-86
9074,1,0,54,0,-54
9075,0,0,8,0,-8
9076,1,0,66,0,-66
9077,0,0,8,0,-8
9078,0,0,0,0,0
9079,0,0,213,0,-213
9080,1,1,146,1743,1597
9081,1,0,128,0,-128
9082,0,0,45,0,-45
9083,1,0,45,0,-45
9084,1,1,461,1312,851
9085,0,0,12,0,-12
9086,1,1,244,2134,1890
9087,0,0,8,0,-8
9088,0,0,14,0,-14
9089,1,0,24,0,-24
9090,1,0,144,0,-144
9091,1,1,949,1544,595
9092,0,0,24,0,-24
9093,0,0,0,0,0
9094,1,0,23,0,-23
9095,0,0,47,0,-47
9096,1,0,43,0,-43
9097,1,0,62,0,-62
9098,1,0,20,0,-20
9099,0,0,0,0,0
9100,0,0,191,0,-191
9101,0,0,9,0,-9
9102,1,0,6,0,-6
9103,0,0,121,0,-121
9104,0,0,4,0,-4
9105,1,0,26,0,-26
9106,0,0,6,0,-6
9107,0,0,153,0,-153
9108,1,0,87,0,-87
9109,0,0,17,0,-17
9110,1,0,4,0,-4
9111,0,0,64,0,-64
9112,1,0,114,0,-114
9113,0,0,29,0,-29
9114,1,1,870,1411,541
9115,1,1,2320,1205,-1115
9116,0,0,162,0,-162
9117,1,0,73,0,-73
9118,1,1,587,1678,1091
9119,1,1,419,1305,886
9120,0,0,58,0,-58
9121,0,0,34,0,-34
9122,0,0,114,0,-114
9123,1,1,1931,1299,-632
9124,0,0,46,0,-46
9125,0,0,29,0,-29
9126,1,0,19,0,-19
9127,1,0,81,0,-81
9128,0,0,16,0,-16
9129,1,1,703,1505,802
9130,0,0,15,0,-15
9131,1,0,45,0,-45
9132,1,1,178,1568,1390
9133,1,0,191,0,-191
9134,1,1,60,2957,2897
9135,0,0,54,0,-54
9136,0,0,1,0,-1
9137,1,1,1122,1279,157
9138,1,0,41,0,-41
9139,1,0,44,0,-44
9140,1,0,28,0,-28
9141,1,1,1188,1432,244
9142,1,1,34,4095,4061
9143,1,1,899,1698,799
9144,0,0,47,0,-47
9145,0,0,27,0,-27
9146,1,1,536,1635,1099
9147,0,0,51,0,-51
9148,1,1,136,1462,1326
9149,1,0,25,0,-25
9150,0,0,60,0,-60
9151,1,1,571,1612,1041
9152,1,0,27,0,-27
9153,0,0,28,0,-28
9154,1,1,87,2822,2735
9155,1,1,399,1332,933
9156,1,1,160,1370,1210
9157,0,0,10,0,-10
9158,0,0,60,0,-60
9159,1,1,277,1313,1036
9160,0,0,72,0,-72
9161,0,0,91,0,-91
9162,1,1,377,1247,870
9163,0,0,20,0,-20
9164,1,0,60,0,-60
9165,1,1,382,1517,1135
9166,1,0,36,0,-36
9167,1,1,810,1201,391
9168,0,0,162,0,-162
9169,0,0,60,0,-60
9170,0,0,46,0,-46
9171,1,1,649,1325,676
9172,0,0,60,0,-60
9173,1,0,7,0,-7
9174,0,0,0,0,0
9175,1,0,27,0,-27
9176,1,0,1,0,-1
9177,0,0,46,0,-46
9178,0,0,63,0,-63
9179,1,0,15,0,-15
9180,0,0,72,0,-72
9181,0,0,87,0,-87
9182,0,0,53,0,-53
9183,1,1,1387,1878,491
9184,1,1,146,1571,1425
9185,1,1,85,1239,1154
9186,1,0,5,0,-5
9187,1,0,11,0,-11
9188,1,0,56,0,-56
9189,0,0,21,0,-21
9190,0,0,10,0,-10
9191,1,0,33,0,-33
9192,1,0,15,0,-15
9193,0,0,16,0,-16
9194,1,1,1998,1226,-772
9195,0,0,0,0,0
9196,0,0,44,0,-44
9197,1,0,54,0,-54
9198,0,0,11,0,-11
9199,1,1,507,2355,1848
9200,1,0,27,0,-27
9201,0,0,14,0,-14
9202,1,0,46,0,-46
9203,0,0,12,0,-12
9204,0,0,52,0,-52
9205,0,0,37,0,-37
9206,0,0,39,0,-39
9207,0,0,32,0,-32
9208,0,0,35,0,-35
9209,1,0,21,0,-21
9210,1,0,49,0,-49
9211,1,1,164,1372,1208
9212,0,0,94,0,-94
9213,1,0,13,0,-13
9214,1,0,105,0,-105
9215,1,1,94,1452,1358
9216,1,0,99,0,-99
9217,1,0,34,0,-34
9218,1,0,59,0,-59
9219,1,0,24,0,-24
9220,0,0,32,0,-32
9221,1,0,1,0,-1
9222,0,0,42,0,-42
9223,1,0,21,0,-21
9224,0,0,59,0,-59
9225,1,0,45,0,-45
9226,0,0,11,0,-11
9227,1,0,35,0,-35
9228,0,0,12,0,-12
9229,1,0,19,0,-19
9230,0,0,20,0,-20
9231,1,1,270,1372,1102
9232,1,1,194,2033,1839
9233,1,0,114,0,-114
9234,0,0,16,0,-16
9235,1,1,412,1293,881
9236,0,0,4,0,-4
9237,0,0,62,0,-62
9238,1,0,79,0,-79
9239,0,0,60,0,-60
9240,0,0,87,0,-87
9241,0,0,17,0,-17
9242,0,0,40,0,-40
9243,1,0,10,0,-10
9244,1,1,499,1294,795
9245,1,0,49,0,-49
9246,0,0,0,0,0
9247,1,0,9,0,-9
9248,0,0,41,0,-41
9249,0,0,8,0,-8
9250,0,0,26,0,-26
9251,1,1,113,1229,1116
9252,1,0,6,0,-6
9253,1,1,479,1234,755
9254,1,0,81,0,-81
9255,1,0,135,0,-135
9256,0,0,112,0,-112
9257,0,0,39,0,-39
9258,0,0,0,0,0
9259,0,0,23,0,-23
9260,1,1,536,1220,684
9261,1,1,507,1361,854
9262,1,0,7,0,-7
9263,1,0,51,0,-51
9264,1,1,175,2281,2106
9265,0,0,45,0,-45
9266,0,0,192,0,-192
9267,0,0,120,0,-120
9268,1,0,15,0,-15
9269,0,0,235,0,-235
9270,1,1,267,2372,2105
9271,0,0,46,0,-46
9272,0,0,97,0,-97
9273,1,0,15,0,-15
9274,0,0,10,0,-10
9275,0,0,122,0,-122
9276,1,0,47,0,-47
9277,0,0,66,0,-66
9278,0,0,86,0,-86
9279,1,1,590,1484,894
9280,0,0,33,0,-33
9281,0,0,31,0,-31
9282,0,0,17,0,-17
9283,1,0,90,0,-90
9284,1,0,3,0,-3
9285,0,0,107,0,-107
9286,1,0,35,0,-35
9287,1,0,13,0,-13
9288,0,0,9,0,-9
9289,0,0,18,0,-18
9290,1,0,35,0,-35
9291,1,0,57,0,-57
9292,1,1,569,1435,866
9293,1,0,102,0,-102
9294,1,0,45,0,-45
9295,1,1,907,1716,809
9296,1,1,852,2337,1485
9297,1,1,2076,3131,1055
9298,1,0,15,0,-15
9299,1,1,1456,1258,-198
9300,1,1,94,1292,1198
9301,0,0,6,0,-6
9302,1,0,2,0,-2
9303,0,0,38,0,-38
9304,1,0,10,0,-10
9305,1,0,15,0,-15
9306,1,1,144,1481,1337
9307,1,1,1203,2128,925
9308,0,0,28,0,-28
9309,1,0,5,0,-5
9310,1,0,11,0,-11
9311,1,1,863,1369,506
9312,0,0,35,0,-35
9313,1,0,69,0,-69
9314,0,0,191,0,-191
9315,1,0,51,0,-51
9316,0,0,36,0,-36
9317,1,0,85,0,-85
9318,1,0,38,0,-38
9319,1,0,82,0,-82
9320,0,0,28,0,-28
9321,1,0,12,0,-12
9322,1,1,63,1669,1606
9323,0,0,14,0,-14
9324,1,0,59,0,-59
9325,0,0,71,0,-71
9326,0,0,3,0,-3
9327,0,0,39,0,-39
9328,0,0,29,0,-29
9329,1,0,1,0,-1
9330,1,0,45,0,-45
9331,1,1,3083,1304,-1779
9332,1,1,160,2654,2494
9333,1,0,32,0,-32
9334,0,0,83,0,-83
9335,0,0,35,0,-35
9336,1,1,345,1356,1011
9337,1,1,21,1470,1449
9338,0,0,127,0,-127
9339,1,0,126,0,-126
9340,1,1,18,1238,1220
9341,1,1,282,1201,919
9342,1,1,262,1236,974
9343,1,1,839,1446,607
9344,1,0,10,0,-10
9345,1,0,27,0,-27
9346,0,0,15,0,-15
9347,0,0,19,0,-19
9348,1,0,69,0,-69
9349,0,0,108,0,-108
9350,1,1,94,2451,2357
9351,0,0,0,0,0
9352,0,0,14,0,-14
9353,0,0,10,0,-10
9354,1,0,0,0,0
9355,1,0,148,0,-148
9356,1,0,57,0,-57
9357,0,0,4,0,-4
9358,1,1,272,1538,1266
9359,1,0,137,0,-137
9360,0,0,73,0,-73
9361,1,1,43,1315,1272
9362,1,0,31,0,-31
9363,0,0,68,0,-68
9364,1,0,60,0,-60
9365,1,0,5,0,-5
9366,1,1,273,1517,1244
9367,1,1,159,1708,1549
9368,0,0,230,0,-230
9369,1,0,166,0,-166
9370,1,1,194,1450,1256
9371,0,0,4,0,-4
9372,1,1,482,1295,813
9373,1,1,268,1422,1154
9374,0,0,50,0,-50
9375,0,0,98,0,-98
9376,0,0,4,0,-4
9377,1,0,12,0,-12
9378,1,1,539,2269,1730
9379,1,1,155,1238,1083
9380,0,0,100,0,-100
9381,0,0,162,0,-162
9382,1,0,110,0,-110
9383,1,1,1448,1584,136
9384,1,0,36,0,-36
9385,1,1,1086,1224,138
9386,0,0,35,0,-35
9387,1,1,732,1651,919
9388,1,1,166,1352,1186
9389,1,0,23,0,-23
9390,1,1,413,1237,824
9391,1,1,107,1431,1324
9392,1,1,204,3464,3260
9393,0,0,100,0,-100
9394,0,0,71,0,-71
9395,1,0,48,0,-48
9396,1,1,1824,1459,-365
9397,1,0,42,0,-42
9398,0,0,1,0,-1
9399,0,0,23,0,-23
9400,1,0,14,0,-14
9401,1,0,12,0,-12
9402,1,0,86,0,-86
9403,1,1,154,1471,1317
9404,1,1,1520,1222,-298
9405,1,0,38,0,-38
9406,0,0,35,0,-35
9407,0,0,87,0,-87
9408,1,1,387,1302,915
9409,1,0,28,0,-28
9410,1,0,60,0,-60
9411,1,1,1188,1230,42
9412,0,0,34,0,-34
9413,1,0,19,0,-19
9414,1,0,45,0,-45
9415,1,0,40,0,-40
9416,1,0,5,0,-5
9417,1,0,35,0,-35
9418,1,0,72,0,-72
9419,0,0,4,0,-4
9420,0,0,8,0,-8
9421,1,0,2,0,-2
9422,0,0,7,0,-7
9423,1,0,19,0,-19
9424,1,1,290,1226,936
9425,1,0,68,0,-68
9426,1,1,1284,1608,324
9427,1,0,28,0,-28
9428,1,0,45,0,-45
9429,0,0,130,0,-130
9430,1,0,8,0,-8
9431,1,0,98,0,-98
9432,0,0,28,0,-28
9433,1,1,948,1319,371
9434,1,1,1489,1204,-285
9435,1,0,27,0,-27
9436,0,0,162,0,-162
9437,1,0,2,0,-2
9438,0,0,5,0,-5
9439,1,0,106,0,-106
9440,1,0,97,0,-97
9441,1,1,1924,1274,-650
9442,0,0,11,0,-11
9443,0,0,114,0,-114
9444,0,0,35,0,-35
9445,0,0,86,0,-86
9446,0,0,46,0,-46
9447,0,0,16,0,-16
9448,1,0,54,0,-54
9449,1,1,327,1314,987
9450,1,1,1518,1315,-203
9451,1,0,0,0,0
9452,0,0,148,0,-148
9453,1,0,3,0,-3
9454,0,0,36,0,-36
9455,0,0,14,0,-14
9456,1,1,867,1984,1117
9457,1,0,28,0,-28
9458,1,0,78,0,-78
9459,0,0,3,0,-3
9460,1,1,175,2125,1950
9461,0,0,225,0,-225
9462,0,0,154,0,-154
9463,1,1,269,1216,947
9464,1,0,19,0,-19
9465,0,0,0,0,0
9466,0,0,37,0,-37
9467,1,0,4,0,-4
9468,1,0,13,0,-13
9469,0,0,14,0,-14
9470,0,0,85,0,-85
9471,0,0,28,0,-28
9472,0,0,188,0,-188
9473,1,1,59,1796,1737
9474,1,1,2766,1249,-1517
9475,0,0,60,0,-60
9476,1,1,26,1253,1227
9477,0,0,94,0,-94
9478,0,0,182,0,-182
9479,0,0,75,0,-75
9480,0,0,7,0,-7
9481,0,0,26,0,-26
9482,0,0,20,0,-20
9483,1,1,392,1232,840
9484,1,1,221,1218,997
9485,1,0,36,0,-36
9486,1,1,66,2279,2213
9487,1,1,1345,1591,246
9488,1,1,913,1226,313
9489,0,0,34,0,-34
9490,1,1,809,1418,609
9491,0,0,19,0,-19
9492,0,0,24,0,-24
9493,1,0,39,0,-39
9494,1,0,149,0,-149
9495,0,0,39,0,-39
9496,1,1,594,1206,612
9497,1,1,694,2707,2013
9498,1,1,154,1403,1249
9499,0,0,16,0,-16
9500,1,0,52,0,-52
9501,0,0,12,0,-12
9502,0,0,36,0,-36
9503,1,1,281,1727,1446
9504,1,0,37,0,-37
9505,0,0,14,0,-14
9506,0,0,57,0,-57
9507,1,0,141,0,-141
9508,1,1,704,1214,510
9509,0,0,13,0,-13
9510,0,0,50,0,-50
9511,1,1,530,2039,1509
9512,0,0,34,0,-34
9513,1,0,3,0,-3
9514,0,0,52,0,-52
9515,0,0,11,0,-11
9516,1,1,485,1321,836
9517,0,0,91,0,-91
9518,0,0,8,0,-8
9519,1,0,89,0,-89
9520,0,0,0,0,0
9521,1,1,170,1359,1189
9522,1,0,2,0,-2
9523,0,0,82,0,-82
9524,1,1,225,1720,1495
9525,0,0,7,0,-7
9526,1,0,18,0,-18
9527,1,0,30,0,-30
9528,1,1,71,1232,1161
9529,1,1,1104,1381,277
9530,1,1,1619,1272,-347
9531,1,1,176,1486,1310
9532,0,0,89,0,-89
9533,0,0,5,0,-5
9534,1,0,1,0,-1
9535,1,0,165,0,-165
9536,0,0,8,0,-8
9537,0,0,45,0,-45
9538,1,0,161,0,-161
9539,1,0,0,0,0
9540,0,0,61,0,-61
9541,1,1,569,1306,737
9542,0,0,71,0,-71
9543,1,1,109,1731,1622
9544,1,0,74,0,-74
9545,1,0,22,0,-22
9546,1,1,2017,2311,294
9547,1,1,67,1339,1272
9548,1,1,1174,1355,181
9549,1,1,182,1250,1068
9550,1,0,16,0,-16
9551,0,0,11,0,-11
9552,1,1,314,1219,905
9553,0,0,4,0,-4
9554,0,0,1,0,-1
9555,1,0,159,0,-159
9556,0,0,59,0,-59
9557,1,0,61,0,-61
9558,0,0,11,0,-11
9559,1,1,512,3492,2980
9560,0,0,197,0,-197
9561,1,1,1399,1234,-165
9562,1,1,69,1388,1319
9563,0,0,107,0,-107
9564,0,0,22,0,-22
9565,1,0,42,0,-42
9566,0,0,60,0,-60
9567,1,1,232,1472,1240
9568,0,0,119,0,-119
9569,0,0,77,0,-77
9570,0,0,18,0,-18
9571,0,0,63,0,-63
9572,1,1,643,1568,925
9573,1,1,181,1221,1040
9574,0,0,3,0,-3
9575,0,0,56,0,-56
9576,0,0,75,0,-75
9577,1,1,796,2889,2093
9578,0,0,16,0,-16
9579,0,0,32,0,-32
9580,0,0,107,0,-107
9581,1,0,52,0,-52
9582,0,0,9,0,-9
9583,1,1,241,1231,990
9584,0,0,3,0,-3
9585,1,0,192,0,-192
9586,1,1,104,1263,1159
9587,1,1,1386,1934,548
9588,1,1,518,1793,1275
9589,0,0,11,0,-11
9590,1,0,1,0,-1
9591,0,0,58,0,-58
9592,0,0,19,0,-19
9593,1,1,1596,1686,90
9594,1,0,19,0,-19
9595,0,0,32,0,-32
9596,0,0,22,0,-22
9597,1,1,432,1581,1149
9598,1,0,9,0,-9
9599,1,1,55,1681,1626
9600,0,0,73,0,-73
9601,0,0,111,0,-111
9602,1,1,436,2062,1626
9603,0,0,32,0,-32
9604,1,1,110,1707,1597
9605,0,0,34,0,-34
9606,0,0,70,0,-70
9607,0,0,15,0,-15
9608,0,0,18,0,-18
9609,0,0,113,0,-113
9610,1,0,38,0,-38
9611,0,0,134,0,-134
9612,0,0,30,0,-30
9613,1,0,64,0,-64
9614,1,1,387,1655,1268
9615,0,0,130,0,-130
9616,1,0,24,0,-24
9617,1,1,74,1627,1553
9618,0,0,2,0,-2
9619,0,0,40,0,-40
9620,0,0,5,0,-5
9621,0,0,5,0,-5
9622,1,0,58,0,-58
9623,1,0,41,0,-41
9624,0,0,108,0,-108
9625,1,1,101,1574,1473
9626,0,0,41,0,-41
9627,1,0,111,0,-111
9628,0,0,281,0,-281
9629,1,1,1145,1632,487
9630,0,0,25,0,-25
9631,1,0,63,0,-63
9632,1,1,365,1444,1079
9633,1,1,634,1204,570
9634,1,0,8,0,-8
9635,1,0,211,0,-211
9636,0,0,67,0,-67
9637,1,1,923,1340,417
9638,1,1,159,1669,1510
9639,1,1,678,1200,522
9640,1,0,92,0,-92
9641,1,1,597,1486,889
9642,1,0,38,0,-38
9643,0,0,75,0,-75
9644,1,0,21,0,-21
9645,1,0,5,0,-5
9646,0,0,79,0,-79
9647,1,0,28,0,-28
9648,0,0,83,0,-83
9649,1,0,77,0,-77
9650,1,0,89,0,-89
9651,1,0,40,0,-40
9652,0,0,3,0,-3
9653,1,1,213,1275,1062
9654,0,0,30,0,-30
9655,1,0,3,0,-3
9656,1,1,411,1200,789
9657,1,1,1058,1297,239
9658,1,1,694,1298,604
9659,0,0,9,0,-9
9660,1,1,738,1907,1169
9661,0,0,40,0,-40
9662,1,1,312,1543,1231
9663,0,0,12,0,-12
9664,0,0,33,0,-33
9665,1,0,126,0,-126
9666,0,0,18,0,-18
9667,0,0,110,0,-110
9668,0,0,61,0,-61
9669,1,0,39,0,-39
9670,1,1,872,3025,2153
9671,1,1,502,2114,1612
9672,0,0,8,0,-8
9673,1,0,45,0,-45
9674,0,0,8,0,-8
9675,1,1,123,1240,1117
9676,0,0,51,0,-51
9677,0,0,91,0,-91
9678,1,0,24,0,-24
9679,0,0,15,0,-15
9680,0,0,63,0,-63
9681,1,0,6,0,-6
9682,0,0,75,0,-75
9683,1,1,796,1276,480
9684,1,0,18,0,-18
9685,1,1,430,1387,957
9686,1,1,602,1629,1027
9687,1,1,693,1318,625
9688,1,0,149,0,-149
9689,0,0,0,0,0
9690,0,0,70,0,-70
9691,1,0,112,0,-112
9692,0,0,24,0,-24
9693,1,1,208,1486,1278
9694,1,1,330,1611,1281
9695,1,1,1158,1778,620
9696,1,1,291,1432,1141
9697,1,0,58,0,-58
9698,0,0,59,0,-59
9699,1,1,249,1486,1237
9700,0,0,52,0,-52
9701,0,0,53,0,-53
9702,0,0,119,0,-119
9703,0,0,1,0,-1
9704,1,1,162,1940,1778
9705,1,0,159,0,-159
9706,0,0,2,0,-2
9707,1,1,508,1268,760
9708,0,0,6,0,-6
9709,1,0,13,0,-13
9710,1,1,619,1617,998
9711,1,0,61,0,-61
9712,1,1,409,1527,1118
9713,1,1,109,1370,1261
9714,0,0,12,0,-12
9715,1,1,115,1396,1281
9716,0,0,13,0,-13
9717,1,0,41,0,-41
9718,1,1,961,1219,258
9719,0,0,159,0,-159
9720,0,0,38,0,-38
9721,1,1,515,1638,1123
9722,0,0,112,0,-112
9723,0,0,22,0,-22
9724,1,0,1,0,-1
9725,1,1,136,1330,1194
9726,0,0,17,0,-17
9727,0,0,59,0,-59
9728,1,1,58,1570,1512
9729,0,0,111,0,-111
9730,1,0,21,0,-21
9731,1,0,137,0,-137
9732,0,0,27,0,-27
9733,1,0,32,0,-32
9734,1,1,202,1350,1148
9735,0,0,6,0,-6
9736,1,1,181,1377,1196
9737,0,0,68,0,-68
9738,1,0,6,0,-6
9739,0,0,233,0,-233
9740,0,0,70,0,-70
9741,0,0,20,0,-20
9742,1,0,1,0,-1
9743,0,0,6,0,-6
9744,1,0,23,0,-23
9745,1,0,12,0,-12
9746,0,0,117,0,-117
9747,0,0,72,0,-72
9748,1,0,103,0,-103
9749,0,0,44,0,-44
9750,1,0,15,0,-15
9751,1,1,551,1319,768
9752,0,0,35,0,-35
9753,0,0,92,0,-92
9754,0,0,31,0,-31
9755,0,0,2,0,-2
9756,1,1,118,1621,1503
9757,0,0,24,0,-24
9758,1,1,743,1548,805
9759,0,0,186,0,-186
9760,1,1,599,1607,1008
9761,0,0,6,0,-6
9762,1,0,70,0,-70
9763,1,1,809,1396,587
9764,0,0,3,0,-3
9765,0,0,30,0,-30
9766,1,1,164,1418,1254
9767,1,1,495,1341,846
9768,0,0,121,0,-121
9769,1,0,47,0,-47
9770,0,0,20,0,-20
9771,0,0,8,0,-8
9772,1,0,17,0,-17
9773,1,0,6,0,-6
9774,1,0,31,0,-31
9775,1,1,172,1231,1059
9776,0,0,3,0,-3
9777,0,0,68,0,-68
9778,1,0,16,0,-16
9779,1,1,750,1217,467
9780,1,0,63,0,-63
9781,1,0,32,0,-32
9782,0,0,25,0,-25
9783,1,0,52,0,-52
9784,1,0,44,0,-44
9785,1,1,216,1552,1336
9786,1,1,534,2468,1934
9787,1,1,488,1825,1337
9788,0,0,13,0,-13
9789,0,0,146,0,-146
9790,1,1,646,1614,968
9791,1,1,246,1331,1085
9792,1,0,8,0,-8
9793,1,0,0,0,0
9794,1,0,34,0,-34
9795,1,1,137,4202,4065
9796,0,0,16,0,-16
9797,1,0,26,0,-26
9798,1,0,47,0,-47
9799,0,0,190,0,-190
9800,1,0,20,0,-20
9801,1,1,1843,1338,-505
9802,1,0,227,0,-227
9803,1,1,307,1360,1053
9804,0,0,70,0,-70
9805,1,1,851,1289,438
9806,1,1,293,1462,1169
9807,1,0,53,0,-53
9808,1,0,39,0,-39
9809,1,1,104,1406,1302
9810,1,0,26,0,-26
9811,1,1,249,1271,1022
9812,1,1,357,2729,2372
9813,0,0,41,0,-41
9814,0,0,37,0,-37
9815,1,1,419,1711,1292
9816,1,1,295,1201,906
9817,0,0,28,0,-28
9818,1,1,214,1541,1327
9819,1,0,41,0,-41
9820,0,0,37,0,-37
9821,0,0,269,0,-269
9822,1,0,50,0,-50
9823,1,0,96,0,-96
9824,0,0,52,0,-52
9825,1,1,481,2282,1801
9826,0,0,212,0,-212
9827,1,1,218,1341,1123
9828,1,1,1334,1573,239
9829,0,0,55,0,-55
9830,1,1,261,1717,1456
9831,1,0,4,0,-4
9832,1,0,8,0,-8
9833,1,1,204,2127,1923
9834,1,1,276,1267,991
9835,0,0,21,0,-21
9836,1,0,131,0,-131
9837,0,0,46,0,-46
9838,1,0,49,0,-49
9839,1,1,154,1230,1076
9840,0,0,35,0,-35
9841,0,0,6,0,-6
9842,0,0,33,0,-33
9843,1,0,76,0,-76
9844,1,0,139,0,-139
9845,1,0,67,0,-67
9846,1,0,102,0,-102
9847,1,1,26,1851,1825
9848,0,0,1,0,-1
9849,0,0,54,0,-54
9850,0,0,36,0,-36
9851,0,0,183,0,-183
9852,0,0,71,0,-71
9853,1,1,1014,1347,333
9854,0,0,16,0,-16
9855,0,0,19,0,-19
9856,1,1,414,3277,2863
9857,0,0,47,0,-47
9858,1,1,455,1288,833
9859,1,0,137,0,-137
9860,1,1,986,1711,725
9861,1,1,55,1377,1322
9862,1,0,1,0,-1
9863,1,1,75,1224,1149
9864,1,0,4,0,-4
9865,1,1,510,1711,1201
9866,1,0,35,0,-35
9867,1,1,565,1605,1040
9868,1,0,0,0,0
9869,1,1,857,1859,1002
9870,1,0,14,0,-14
9871,1,0,70,0,-70
9872,1,1,163,1421,1258
9873,0,0,13,0,-13
9874,0,0,53,0,-53
9875,1,0,37,0,-37
9876,1,0,35,0,-35
9877,1,0,59,0,-59
9878,0,0,25,0,-25
9879,1,1,228,1621,1393
9880,1,0,187,0,-187
9881,1,0,17,0,-17
9882,1,0,9,0,-9
9883,1,0,108,0,-108
9884,1,1,579,1384,805
9885,1,1,293,1431,1138
9886,1,0,74,0,-74
9887,0,0,3,0,-3
9888,1,0,55,0,-55
9889,0,0,9,0,-9
9890,0,0,19,0,-19
9891,0,0,30,0,-30
9892,0,0,16,0,-16
9893,1,0,88,0,-88
9894,0,0,53,0,-53
9895,1,0,12,0,-12
9896,1,0,27,0,-27
9897,1,0,85,0,-85
9898,0,0,10,0,-10
9899,1,1,597,1340,743
9900,1,1,197,1330,1133
9901,0,0,73,0,-73
9902,0,0,26,0,-26
9903,0,0,67,0,-67
9904,0,0,41,0,-41
9905,0,0,7,0,-7
9906,1,0,10,0,-10
9907,0,0,38,0,-38
9908,1,0,14,0,-14
9909,0,0,3,0,-3
9910,1,1,2200,1639,-561
9911,1,0,5,0,-5
9912,1,1,612,1238,626
9913,0,0,114,0,-114
9914,0,0,73,0,-73
9915,0,0,8,0,-8
9916,0,0,352,0,-352
9917,1,1,86,1532,1446
9918,1,0,75,0,-75
9919,1,1,97,1705,1608
9920,1,1,86,1562,1476
9921,1,0,1,0,-1
9922,1,0,90,0,-90
9923,0,0,56,0,-56
9924,1,0,113,0,-113
9925,0,0,16,0,-16
9926,0,0,66,0,-66
9927,1,0,45,0,-45
9928,0,0,13,0,-13
9929,1,0,7,0,-7
9930,1,1,481,1200,719
9931,1,0,10,0,-10
9932,1,1,772,1295,523
9933,0,0,59,0,-59
9934,1,1,385,1281,896
9935,1,1,37,1659,1622
9936,0,0,0,0,0
9937,0,0,1,0,-1
9938,0,0,55,0,-55
9939,1,1,145,1237,1092
9940,0,0,81,0,-81
9941,1,0,73,0,-73
9942,1,0,11,0,-11
9943,1,0,43,0,-43
9944,0,0,0,0,0
9945,1,0,46,0,-46
9946,1,0,20,0,-20
9947,1,1,1590,1366,-224
9948,0,0,32,0,-32
9949,1,0,25,0,-25
9950,1,1,125,1475,1350
9951,1,1,310,1419,1109
9952,0,0,32,0,-32
9953,1,1,417,1319,902
9954,0,0,54,0,-54
9955,0,0,47,0,-47
9956,1,1,1908,1262,-646
9957,1,0,102,0,-102
9958,1,0,4,0,-4
9959,1,1,612,1661,1049
9960,1,1,1108,2197,1089
9961,0,0,32,0,-32
9962,0,0,80,0,-80
9963,1,0,98,0,-98
9964,1,1,351,1457,1106
9965,1,0,58,0,-58
9966,1,0,12,0,-12
9967,1,0,52,0,-52
9968,0,0,9,0,-9
9969,1,1,1066,1341,275
9970,0,0,26,0,-26
9971,1,1,597,1590,993
9972,0,0,148,0,-148
9973,0,0,9,0,-9
9974,1,1,83,1300,1217
9975,0,0,89,0,-89
9976,1,0,2,0,-2
9977,1,0,180,0,-180
9978,1,0,21,0,-21
9979,0,0,46,0,-46
9980,1,0,11,0,-11
9981,1,0,7,0,-7
9982,1,1,51,1217,1166
9983,0,0,24,0,-24
9984,1,0,23,0,-23
9985,0,0,56,0,-56
9986,1,1,21,1277,1256
9987,0,0,214,0,-214
9988,1,1,285,1259,974
9989,1,0,47,0,-47
9990,1,1,519,2559,2040
9991,0,0,37,0,-37
9992,1,0,28,0,-28
9993,1,0,34,0,-34
9994,0,0,22,0,-22
9995,1,1,340,1260,920
9996,0,0,62,0,-62
9997,1,0,40,0,-40
9998,0,0,28,0,-28
9999,0,0,82,0,-82
10000,1,0,45,0,-45
10001,1,1,964,2134,1170
10002,1,0,48,0,-48
10003,0,0,61,0,-61
10004,1,1,27,1283,1256
10005,1,0,25,0,-25
10006,1,0,92,0,-92
10007,1,1,187,1819,1632
10008,1,0,21,0,-21
10009,0,0,13,0,-13
10010,1,1,227,1363,1136
10011,1,1,1106,2828,1722
10012,1,0,7,0,-7
10013,1,1,207,1309,1102
10014,0,0,53,0,-53
10015,1,1,1803,1267,-536
10016,1,1,288,1375,1087
10017,0,0,141,0,-141
10018,0,0,46,0,-46
10019,0,0,7,0,-7
10020,1,0,106,0,-106
10021,1,0,72,0,-72
10022,1,1,344,1273,929
10023,0,0,4,0,-4
10024,0,0,26,0,-26
10025,0,0,10,0,-10
10026,1,1,347,1204,857
10027,1,0,10,0,-10
10028,1,1,548,1533,985
10029,1,0,137,0,-137
10030,0,0,28,0,-28
10031,1,0,83,0,-83
10032,1,0,31,0,-31
10033,1,1,361,1471,1110
10034,0,0,301,0,-301
10035,1,1,658,1463,805
10036,1,0,46,0,-46
10037,1,0,55,0,-55
10038,1,1,375,1451,1076
10039,1,0,64,0,-64
10040,0,0,10,0,-10
10041,1,1,1508,1384,-124
10042,1,0,188,0,-188
10043,0,0,65,0,-65
10044,0,0,37,0,-37
10045,0,0,24,0,-24
10046,1,1,728,1429,701
10047,1,1,202,1381,1179
10048,1,1,1121,2163,1042
10049,1,0,102,0,-102
10050,1,0,67,0,-67
10051,1,1,419,1304,885
10052,1,1,655,1203,548
10053,1,1,511,1359,848
10054,1,0,16,0,-16
10055,1,0,23,0,-23
10056,1,0,0,0,0
10057,1,1,1104,1967,863
10058,0,0,1,0,-1
10059,0,0,5,0,-5
10060,0,0,24,0,-24
10061,1,1,200,1760,1560
10062,1,1,478,1260,782
10063,1,0,27,0,-27
10064,1,0,0,0,0
10065,0,0,19,0,-19
10066,1,0,99,0,-99
10067,1,1,1530,1231,-299
10068,1,0,25,0,-25
10069,0,0,5,0,-5
10070,1,1,34,1285,1251
10071,0,0,16,0,-16
10072,1,1,121,1285,1164
10073,1,1,787,1309,522
10074,1,0,42,0,-42
10075,1,1,325,1484,1159
10076,0,0,2,0,-2
10077,1,0,58,0,-58
10078,0,0,25,0,-25
10079,1,0,22,0,-22
10080,1,0,6,0,-6
10081,1,1,805,1672,867
10082,0,0,14,0,-14
10083,1,1,247,1497,1250
10084,1,1,1562,1401,-161
10085,0,0,13,0,-13
10086,1,1,409,1461,1052
10087,0,0,81,0,-81
10088,1,0,25,0,-25
10089,0,0,85,0,-85
10090,1,1,34,2027,1993
10091,0,0,23,0,-23
10092,1,0,19,0,-19
10093,1,1,672,1331,659
10094,0,0,19,0,-19
10095,1,1,419,1342,923
10096,1,1,796,1465,669
10097,1,0,124,0,-124
10098,0,0,53,0,-53
10099,0,0,53,0,-53
10100,0,0,8,0,-8
10101,1,0,23,0,-23
10102,1,1,1759,1239,-520
10103,0,0,13,0,-13
10104,0,0,18,0,-18
10105,0,0,71,0,-71
10106,0,0,59,0,-59
10107,0,0,38,0,-38
10108,0,0,72,0,-72
10109,1,0,6,0,-6
10110,1,0,12,0,-12
10111,0,0,104,0,-104
10112,1,1,442,1813,1371
10113,1,0,0,0,0
10114,1,1,87,1404,1317
10115,0,0,151,0,-151
10116,1,1,117,1449,1332
10117,0,0,52,0,-52
10118,1,0,19,0,-19
10119,1,0,33,0,-33
10120,1,1,198,1937,1739
10121,0,0,61,0,-61
10122,1,0,13,0,-13
10123,0,0,64,0,-64
10124,0,0,33,0,-33
10125,0,0,132,0,-132
10126,1,0,38,0,-38
10127,1,1,190,1245,1055
10128,0,0,18,0,-18
10129,1,0,4,0,-4
10130,1,1,127,1735,1608
10131,0,0,212,0,-212
10132,1,0,48,0,-48
10133,1,1,243,1327,1084
10134,1,1,705,1208,503
10135,0,0,1,0,-1
10136,1,1,1041,1893,852
10137,0,0,48,0,-48
10138,1,1,702,1605,903
10139,0,0,58,0,-58
10140,1,1,334,1616,1282
10141,0,0,111,0,-111
10142,1,0,29,0,-29
10143,1,0,4,0,-4
10144,1,0,9,0,-9
10145,1,1,63,1232,1169
10146,0,0,33,0,-33
10147,1,1,82,1549,1467
10148,0,0,35,0,-35
10149,0,0,22,0,-22
10150,1,0,37,0,-37
10151,0,0,11,0,-11
10152,1,1,2004,1599,-405
10153,1,1,691,1324,633
10154,1,1,894,1657,763
10155,1,0,8,0,-8
10156,0,0,17,0,-17
10157,0,0,0,0,0
10158,1,1,158,1622,1464
10159,0,0,48,0,-48
10160,1,0,131,0,-131
10161,1,1,211,1333,1122
10162,1,0,76,0,-76
10163,1,0,10,0,-10
10164,1,1,139,1463,1324
10165,1,0,2,0,-2
10166,0,0,80,0,-80
10167,1,0,15,0,-15
10168,1,0,52,0,-52
10169,1,0,7,0,-7
10170,1,1,1362,1736,374
10171,0,0,73,0,-73
10172,1,0,140,0,-140
10173,1,1,723,1202,479
10174,0,0,9,0,-9
10175,1,0,22,0,-22
10176,1,0,59,0,-59
10177,0,0,10,0,-10
10178,1,0,111,0,-111
10179,0,0,41,0,-41
10180,0,0,33,0,-33
10181,1,0,19,0,-19
10182,1,1,283,1268,985
10183,0,0,18,0,-18
10184,1,1,201,1463,1262
10185,0,0,134,0,-134
10186,0,0,10,0,-10
10187,1,0,37,0,-37
10188,1,1,416,1276,860
10189,1,0,24,0,-24
10190,1,1,577,2125,1548
10191,0,0,24,0,-24
10192,0,0,158,0,-158
10193,0,0,0,0,0
10194,1,1,209,1385,1176
10195,1,1,3736,1361,-2375
10196,1,0,2,0,-2
10197,1,1,515,1714,1199
10198,0,0,47,0,-47
10199,1,0,60,0,-60
10200,1,0,42,0,-42
10201,1,0,12,0,-12
10202,1,0,4,0,-4
10203,1,1,1409,1710,301
10204,0,0,33,0,-33
10205,0,0,161,0,-161
10206,1,0,20,0,-20
10207,1,1,1403,2663,1260
10208,0,0,35,0,-35
10209,1,1,767,1240,473
10210,1,0,27,0,-27
10211,1,0,7,0,-7
10212,1,1,204,1337,1133
10213,0,0,38,0,-38
10214,1,0,6,0,-6
10215,0,0,11,0,-11
10216,1,0,24,0,-24
10217,0,0,87,0,-87
10218,1,0,3,0,-3
10219,0,0,81,0,-81
10220,0,0,25,0,-25
10221,1,0,32,0,-32
10222,1,1,1320,1386,66
10223,0,0,79,0,-79
10224,0,0,26,0,-26
10225,1,0,47,0,-47
10226,1,0,11,0,-11
10227,0,0,7,0,-7
10228,0,0,58,0,-58
10229,0,0,22,0,-22
10230,1,0,109,0,-109
10231,0,0,47,0,-47
10232,0,0,91,0,-91
10233,0,0,3,0,-3
10234,1,1,65,2425,2360
10235,1,1,1080,1977,897
10236,0,0,15,0,-15
10237,1,0,14,0,-14
10238,0,0,14,0,-14
10239,0,0,1,0,-1
10240,1,1,189,1319,1130
10241,1,0,82,0,-82
10242,1,1,389,1479,1090
10243,0,0,87,0,-87
10244,1,0,38,0,-38
10245,0,0,7,0,-7
10246,1,0,37,0,-37
10247,1,1,93,1948,1855
10248,1,1,1005,1212,207
10249,0,0,26,0,-26
10250,1,1,2411,1577,-834
10251,0,0,1,0,-1
10252,1,0,51,0,-51
10253,1,1,15,1590,1575
10254,1,1,449,1415,966
10255,0,0,22,0,-22
10256,1,0,9,0,-9
10257,1,1,34,2656,2622
10258,1,0,45,0,-45
10259,0,0,61,0,-61
10260,0,0,115,0,-115
10261,0,0,24,0,-24
10262,0,0,33,0,-33
10263,0,0,58,0,-58
10264,1,0,38,0,-38
10265,1,0,6,0,-6
10266,1,1,728,1287,559
10267,1,0,35,0,-35
10268,1,0,69,0,-69
10269,1,1,2148,1320,-828
10270,0,0,25,0,-25
10271,1,1,182,1266,1084
10272,1,0,9,0,-9
10273,1,0,56,0,-56
10274,0,0,43,0,-43
10275,0,0,32,0,-32
10276,0,0,1,0,-1
10277,0,0,17,0,-17
10278,0,0,35,0,-35
10279,1,0,51,0,-51
10280,1,0,99,0,-99
10281,0,0,8,0,-8
10282,1,0,1,0,-1
10283,0,0,28,0,-28
10284,1,0,15,0,-15
10285,1,1,67,1288,1221
10286,1,1,89,2569,2480
10287,1,1,330,1920,1590
10288,0,0,125,0,-125
10289,1,1,379,1312,933
10290,1,0,55,0,-55
10291,0,0,140,0,-140
10292,1,0,93,0,-93
10293,1,0,61,0,-61
10294,0,0,39,0,-39
10295,0,0,3,0,-3
10296,1,0,24,0,-24
10297,0,0,9,0,-9
10298,0,0,1,0,-1
10299,0,0,113,0,-113
10300,1,0,4,0,-4
10301,0,0,8,0,-8
10302,1,0,83,0,-83
10303,1,0,0,0,0
10304,1,1,141,1314,1173
10305,1,1,48,1232,1184
10306,0,0,4,0,-4
10307,0,0,5,0,-5
10308,0,0,29,0,-29
10309,1,0,16,0,-16
10310,1,0,46,0,-46
10311,1,1,1311,1505,194
10312,1,0,37,0,-37
10313,0,0,4,0,-4
10314,1,1,264,1709,1445
10315,1,0,14,0,-14
10316,0,0,128,0,-128
10317,0,0,25,0,-25
10318,0,0,47,0,-47
10319,1,0,39,0,-39
10320,0,0,22,0,-22
10321,1,0,9,0,-9
10322,1,1,231,1249,1018
10323,0,0,46,0,-46
10324,1,1,397,1258,861
10325,0,0,9,0,-9
10326,1,1,421,1392,971
10327,0,0,82,0,-82
10328,0,0,65,0,-65
10329,0,0,17,0,-17
10330,1,1,370,1797,1427
10331,1,1,90,1563,1473
10332,0,0,11,0,-11
10333,1,0,42,0,-42
10334,0,0,6,0,-6
10335,1,1,271,1790,1519
10336,1,0,37,0,-37
10337,0,0,58,0,-58
10338,1,0,146,0,-146
10339,1,1,73,1399,1326
10340,1,0,78,0,-78
10341,1,1,761,1610,849
10342,1,1,346,3048,2702
10343,0,0,39,0,-39
10344,0,0,71,0,-71
10345,1,1,271,1767,1496
10346,1,0,65,0,-65
10347,1,1,1796,1263,-533
10348,1,1,283,1650,1367
10349,0,0,155,0,-155
10350,0,0,60,0,-60
10351,0,0,50,0,-50
10352,0,0,36,0,-36
10353,1,0,13,0,-13
10354,1,0,79,0,-79
10355,0,0,32,0,-32
10356,1,0,48,0,-48
10357,1,1,256,1405,1149
10358,0,0,22,0,-22
10359,1,0,56,0,-56
10360,0,0,36,0,-36
10361,1,1,135,3617,3482
10362,0,0,172,0,-172
10363,0,0,45,0,-45
10364,0,0,105,0,-105
10365,1,0,36,0,-36
10366,1,0,33,0,-33
10367,1,1,140,1604,1464
10368,0,0,63,0,-63
10369,0,0,39,0,-39
10370,1,0,90,0,-90
10371,0,0,25,0,-25
10372,1,0,36,0,-36
10373,0,0,24,0,-24
10374,1,0,72,0,-72
10375,0,0,19,0,-19
10376,1,0,66,0,-66
10377,1,1,815,1840,1025
10378,1,0,11,0,-11
10379,1,1,119,1553,1434
10380,1,0,13,0,-13
10381,0,0,106,0,-106
10382,1,0,18,0,-18
10383,1,1,746,1449,703
10384,1,0,45,0,-45
10385,1,1,374,1265,891
10386,1,0,10,0,-10
10387,0,0,61,0,-61
10388,0,0,183,0,-183
10389,1,1,411,2353,1942
10390,1,0,17,0,-17
10391,1,1,947,1366,419
10392,1,1,148,1324,1176
10393,1,1,317,1272,955
10394,0,0,34,0,-34
10395,1,0,45,0,-45
10396,0,0,136,0,-136
10397,1,0,42,0,-42
10398,0,0,13,0,-13
10399,1,0,1,0,-1
10400,1,1,288,2095,1807
10401,0,0,22,0,-22
10402,0,0,142,0,-142
10403,0,0,42,0,-42
10404,1,1,250,1231,981
10405,1,0,18,0,-18
10406,1,0,91,0,-91
10407,1,0,8,0,-8
10408,0,0,8,0,-8
10409,0,0,48,0,-48
10410,1,0,31,0,-31
10411,1,1,1868,1346,-522
10412,1,1,363,1517,1154
10413,1,0,276,0,-276
10414,0,0,15,0,-15
10415,0,0,62,0,-62
10416,1,1,254,1235,981
10417,1,0,91,0,-91
10418,0,0,16,0,-16
10419,1,1,493,1316,823
10420,0,0,155,0,-155
10421,1,1,1335,1371,36
10422,1,0,40,0,-40
10423,1,0,20,0,-20
10424,1,1,109,1883,1774
10425,0,0,176,0,-176
10426,0,0,53,0,-53
10427,0,0,9,0,-9
10428,1,1,418,1557,1139
10429,0,0,47,0,-47
10430,0,0,20,0,-20
10431,1,0,76,0,-76
10432,0,0,2,0,-2
10433,1,0,2,0,-2
10434,1,0,105,0,-105
10435,0,0,4,0,-4
10436,1,0,9,0,-9
10437,1,1,1874,1814,-60
10438,0,0,12,0,-12
10439,0,0,27,0,-27
10440,1,0,0,0,0
10441,0,0,80,0,-80
10442,0,0,14,0,-14
10443,0,0,62,0,-62
10444,1,0,60,0,-60
10445,1,1,367,1290,923
10446,1,0,9,0,-9
10447,1,0,37,0,-37
10448,0,0,53,0,-53
10449,1,1,169,1561,1392
10450,1,1,1476,1457,-19
10451,1,0,23,0,-23
10452,0,0,2,0,-2
10453,1,0,9,0,-9
10454,1,0,22,0,-22
10455,1,0,5,0,-5
10456,0,0,31,0,-31
10457,1,1,923,2222,1299
10458,1,1,37,1256,1219
10459,1,1,192,1340,1148
10460,1,0,28,0,-28
10461,1,0,38,0,-38
10462,1,1,777,1204,427
10463,1,0,21,0,-21
10464,0,0,11,0,-11
10465,0,0,133,0,-133
10466,1,1,6,1248,1242
10467,1,0,27,0,-27
10468,1,0,10,0,-10
10469,0,0,130,0,-130
10470,1,0,9,0,-9
10471,1,0,12,0,-12
10472,1,0,5,0,-5
10473,1,0,93,0,-93
10474,1,1,111,2045,1934
10475,1,0,32,0,-32
10476,1,1,270,1300,1030
10477,0,0,21,0,-21
10478,0,0,54,0,-54
10479,1,1,88,4216,4128
10480,1,1,42,1788,1746
10481,1,0,8,0,-8
10482,1,1,318,1533,1215
10483,0,0,0,0,0
10484,1,1,104,1292,1188
10485,0,0,19,0,-19
10486,0,0,29,0,-29
10487,1,1,1219,1406,187
10488,1,1,641,1602,961
10489,0,0,9,0,-9
10490,0,0,61,0,-61
10491,1,1,190,1274,1084
10492,1,1,1450,2079,629
10493,1,1,412,1390,978
10494,1,1,55,1481,1426
10495,1,1,1088,1233,145
10496,1,1,241,4406,4165
10497,1,0,10,0,-10
10498,1,1,285,1600,1315
10499,0,0,51,0,-51
10500,1,0,33,0,-33
10501,1,0,10,0,-10
10502,0,0,16,0,-16
10503,0,0,53,0,-53
10504,0,0,63,0,-63
10505,0,0,15,0,-15
10506,1,0,30,0,-30
10507,1,1,444,1343,899
10508,0,0,13,0,-13
10509,1,1,400,1292,892
10510,1,0,41,0,-41
10511,0,0,29,0,-29
10512,1,0,127,0,-127
10513,0,0,6,0,-6
10514,0,0,497,0,-497
10515,1,0,1,0,-1
10516,0,0,20,0,-20
10517,0,0,10,0,-10
10518,1,1,653,1491,838
10519,1,0,3,0,-3
10520,0,0,3,0,-3
10521,1,0,43,0,-43
10522,0,0,19,0,-19
10523,1,1,426,1491,1065
10524,1,1,2095,1728,-367
10525,0,0,175,0,-175
10526,0,0,84,0,-84
10527,1,0,51,0,-51
10528,1,0,51,0,-51
10529,0,0,49,0,-49
10530,1,1,1166,1855,689
10531,0,0,6,0,-6
10532,0,0,30,0,-30
10533,1,1,93,1418,1325
10534,1,0,106,0,-106
10535,1,1,245,1229,984
10536,1,1,319,1288,969
10537,1,0,39,0,-39
10538,1,1,291,1603,1312
10539,1,1,198,1210,1012
10540,1,1,616,1522,906
10541,1,1,600,1474,874
10542,1,0,31,0,-31
10543,0,0,8,0,-8
10544,1,0,14,0,-14
10545,1,0,8,0,-8
10546,0,0,24,0,-24
10547,1,1,390,1710,1320
10548,1,0,100,0,-100
10549,1,1,738,1325,587
10550,1,0,101,0,-101
10551,0,0,72,0,-72
10552,0,0,64,0,-64
10553,1,1,1150,1879,729
10554,1,1,239,1797,1558
10555,0,0,20,0,-20
10556,0,0,111,0,-111
10557,1,0,19,0,-19
10558,1,1,98,1329,1231
10559,1,0,1,0,-1
10560,0,0,35,0,-35
10561,0,0,69,0,-69
10562,0,0,95,0,-95
10563,0,0,25,0,-25
10564,1,1,898,2077,1179
10565,1,1,235,1641,1406
10566,0,0,73,0,-73
10567,0,0,10,0,-10
10568,1,0,63,0,-63
10569,1,0,45,0,-45
10570,1,1,352,2397,2045
10571,0,0,4,0,-4
10572,0,0,1,0,-1
10573,1,0,29,0,-29
10574,1,0,7,0,-7
10575,1,0,26,0,-26
10576,0,0,48,0,-48
10577,1,1,54,1268,1214
10578,1,0,81,0,-81
10579,1,1,412,1305,893
10580,0,0,28,0,-28
10581,0,0,175,0,-175
10582,1,1,1337,1783,446
10583,1,0,42,0,-42
10584,1,1,708,1292,584
10585,1,0,63,0,-63
10586,0,0,67,0,-67
10587,1,1,77,1424,1347
10588,1,0,27,0,-27
10589,0,0,32,0,-32
10590,0,0,33,0,-33
10591,1,0,84,0,-84
10592,1,0,12,0,-12
10593,1,0,19,0,-19
10594,0,0,13,0,-13
10595,0,0,75,0,-75
10596,1,0,20,0,-20
10597,1,1,137,1297,1160
10598,0,0,7,0,-7
10599,1,0,74,0,-74
10600,1,0,44,0,-44
10601,0,0,51,0,-51
10602,0,0,24,0,-24
10603,0,0,52,0,-52
10604,1,0,4,0,-4
10605,0,0,25,0,-25
10606,1,0,66,0,-66
10607,1,0,110,0,-110
10608,0,0,24,0,-24
10609,0,0,10,0,-10
10610,0,0,53,0,-53
10611,1,1,216,1566,1350
10612,0,0,38,0,-38
10613,0,0,112,0,-112
10614,1,0,65,0,-65
10615,1,1,94,1296,1202
10616,1,1,276,1278,1002
10617,1,0,37,0,-37
10618,1,0,19,0,-19
10619,0,0,32,0,-32
10620,1,1,165,2436,2271
10621,0,0,78,0,-78
10622,0,0,133,0,-133
10623,0,0,65,0,-65
10624,0,0,80,0,-80
10625,1,0,52,0,-52
10626,1,0,28,0,-28
10627,1,0,13,0,-13
10628,1,1,182,1243,1061
10629,1,1,483,1329,846
10630,1,1,364,1571,1207
10631,0,0,0,0,0
10632,1,0,28,0,-28
10633,1,1,668,1307,639
10634,1,1,254,1470,1216
10635,0,0,60,0,-60
10636,0,0,32,0,-32
10637,0,0,70,0,-70
10638,1,0,110,0,-110
10639,1,0,87,0,-87
10640,1,0,60,0,-60
10641,1,0,42,0,-42
10642,1,0,5,0,-5
10643,0,0,40,0,-40
10644,1,0,13,0,-13
10645,1,0,25,0,-25
10646,0,0,61,0,-61
10647,1,1,767,1639,872
10648,1,0,28,0,-28
10649,0,0,14,0,-14
10650,0,0,23,0,-23
10651,0,0,14,0,-14
10652,1,1,172,1378,1206
10653,0,0,1,0,-1
10654,1,1,19,2719,2700
10655,1,0,251,0,-251
10656,0,0,48,0,-48
10657,1,0,18,0,-18
10658,0,0,87,0,-87
10659,1,0,20,0,-20
10660,1,1,155,1427,1272
10661,1,0,68,0,-68
10662,1,1,374,1796,1422
10663,1,0,9,0,-9
10664,0,0,0,0,0
10665,1,1,394,2128,1734
10666,1,0,70,0,-70
10667,1,1,692,1264,572
10668,1,1,682,1950,1268
10669,1,0,74,0,-74
10670,1,1,132,1312,1180
10671,1,1,791,1518,727
10672,1,1,494,1450,956
10673,1,1,132,1222,1090
10674,0,0,11,0,-11
10675,0,0,34,0,-34
10676,1,1,33,1341,1308
10677,0,0,5,0,-5
10678,1,0,42,0,-42
10679,1,0,61,0,-61
10680,1,1,604,1522,918
10681,1,0,41,0,-41
10682,1,1,599,1317,718
10683,0,0,100,0,-100
10684,1,0,50,0,-50
10685,1,0,78,0,-78
10686,1,1,1449,1254,-195
10687,1,0,217,0,-217
10688,1,1,477,1520,1043
10689,1,0,62,0,-62
10690,0,0,100,0,-100
10691,1,1,408,1298,890
10692,0,0,10,0,-10
10693,1,1,147,2118,1971
10694,1,0,12,0,-12
10695,1,0,4,0,-4
10696,1,1,250,1535,1285
10697,1,0,23,0,-23
10698,0,0,83,0,-83
10699,1,0,89,0,-89
10700,0,0,173,0,-173
10701,0,0,20,0,-20
10702,1,1,78,1294,1216
10703,0,0,78,0,-78
10704,1,0,188,0,-188
10705,0,0,30,0,-30
10706,1,1,571,1363,792
10707,0,0,83,0,-83
10708,1,0,69,0,-69
10709,1,0,80,0,-80
10710,0,0,5,0,-5
10711,0,0,75,0,-75
10712,0,0,164,0,-164
10713,0,0,35,0,-35
10714,0,0,14,0,-14
10715,1,1,234,1248,1014
10716,0,0,134,0,-134
10717,0,0,30,0,-30
10718,0,0,10,0,-10
10719,0,0,14,0,-14
10720,1,1,196,2606,2410
10721,1,0,19,0,-19
10722,1,0,30,0,-30
10723,1,1,285,1226,941
10724,0,0,8,0,-8
10725,1,1,505,1525,1020
10726,1,0,52,0,-52
10727,1,0,21,0,-21
10728,0,0,102,0,-102
10729,0,0,48,0,-48
10730,1,0,1,0,-1
10731,1,1,356,1307,951
10732,0,0,0,0,0
10733,1,0,112,0,-112
10734,1,1,558,1369,811
10735,1,1,243,1448,1205
10736,0,0,102,0,-102
10737,1,0,18,0,-18
10738,0,0,32,0,-32
10739,0,0,79,0,-79
10740,1,0,50,0,-50
10741,0,0,35,0,-35
10742,1,0,95,0,-95
10743,1,1,622,1291,669
10744,1,1,1072,1421,349
10745,1,1,2124,1483,-641
10746,1,0,134,0,-134
10747,0,0,161,0,-161
10748,1,1,142,1536,1394
10749,1,0,20,0,-20
10750,0,0,19,0,-19
10751,1,1,1228,1498,270
10752,1,0,30,0,-30
10753,0,0,25,0,-25
10754,1,0,1,0,-1
10755,1,1,300,1227,927
10756,1,1,711,1891,1180
10757,0,0,13,0,-13
10758,0,0,0,0,0
10759,1,0,75,0,-75
10760,1,0,51,0,-51
10761,0,0,37,0,-37
10762,0,0,1,0,-1
10763,1,0,9,0,-9
10764,0,0,97,0,-97
10765,1,1,427,1682,1255
10766,0,0,112,0,-112
10767,1,0,31,0,-31
10768,1,1,588,1381,793
10769,0,0,14,0,-14
10770,1,1,301,1234,933
10771,0,0,63,0,-63
10772,1,0,128,0,-128
10773,1,1,763,1882,1119
10774,0,0,0,0,0
10775,0,0,72,0,-72
10776,1,0,93,0,-93
10777,1,0,18,0,-18
10778,0,0,100,0,-100
10779,1,1,111,1748,1637
10780,0,0,0,0,0
10781,0,0,23,0,-23
10782,1,1,203,3122,2919
10783,0,0,18,0,-18
10784,1,0,3,0,-3
10785,1,0,35,0,-35
10786,0,0,27,0,-27
10787,0,0,10,0,-10
10788,1,1,748,1217,469
10789,1,0,149,0,-149
10790,1,1,83,1310,1227
10791,0,0,128,0,-128
10792,1,1,1028,2589,1561
10793,1,1,935,1458,523
10794,0,0,37,0,-37
10795,1,1,269,2393,2124
10796,0,0,83,0,-83
10797,0,0,20,0,-20
10798,0,0,22,0,-22
10799,0,0,120,0,-120
10800,1,0,13,0,-13
10801,0,0,16,0,-16
10802,1,0,95,0,-95
10803,1,1,214,1954,1740
10804,0,0,51,0,-51
10805,0,0,30,0,-30
10806,1,1,1283,1285,2
10807,1,1,1119,1894,775
10808,0,0,41,0,-41
10809,1,1,176,1987,1811
10810,1,0,16,0,-16
10811,0,0,0,0,0
10812,0,0,13,0,-13
10813,0,0,9,0,-9
10814,1,1,866,1334,468
10815,1,0,17,0,-17
10816,1,0,32,0,-32
10817,0,0,83,0,-83
10818,1,0,3,0,-3
10819,1,1,38,1357,1319
10820,1,0,30,0,-30
10821,0,0,69,0,-69
10822,1,0,100,0,-100
10823,0,0,78,0,-78
10824,0,0,91,0,-91
10825,1,0,86,0,-86
10826,0,0,154,0,-154
10827,1,0,50,0,-50
10828,1,1,304,1305,1001
10829,0,0,1,0,-1
10830,0,0,29,0,-29
10831,1,1,1314,1808,494
10832,1,1,760,1226,466
10833,1,0,20,0,-20
10834,0,0,38,0,-38
10835,1,0,114,0,-114
10836,0,0,51,0,-51
10837,1,0,169,0,-169
10838,1,1,136,1440,1304
10839,1,0,86,0,-86
10840,0,0,96,0,-96
10841,1,0,67,0,-67
10842,1,0,41,0,-41
10843,1,0,37,0,-37
10844,0,0,39,0,-39
10845,1,1,651,3214,2563
10846,1,1,660,1229,569
10847,0,0,84,0,-84
10848,0,0,217,0,-217
10849,0,0,119,0,-119
10850,1,1,1391,1202,-189
10851,1,0,26,0,-26
10852,1,1,17,1239,1222
10853,1,0,95,0,-95
10854,0,0,27,0,-27
10855,1,1,1378,1641,263
10856,1,1,431,1492,1061
10857,1,0,99,0,-99
10858,0,0,33,0,-33
10859,0,0,14,0,-14
10860,1,1,308,1575,1267
10861,1,1,879,1320,441
10862,1,1,239,1269,1030
10863,0,0,3,0,-3
10864,0,0,72,0,-72
10865,0,0,26,0,-26
10866,0,0,139,0,-139
10867,1,1,998,1236,238
10868,1,1,598,1459,861
10869,0,0,72,0,-72
10870,1,0,68,0,-68
10871,0,0,54,0,-54
10872,1,0,3,0,-3
10873,1,1,876,1292,416
10874,1,0,64,0,-64
10875,0,0,35,0,-35
10876,1,0,58,0,-58
10877,0,0,42,0,-42
10878,1,1,319,1277,958
10879,0,0,41,0,-41
10880,1,1,74,2125,2051
10881,1,0,38,0,-38
10882,0,0,97,0,-97
10883,0,0,93,0,-93
10884,1,0,23,0,-23
10885,1,1,882,1257,375
10886,1,0,24,0,-24
10887,1,1,725,1349,624
10888,1,0,25,0,-25
10889,1,1,791,2110,1319
10890,1,0,86,0,-86
10891,0,0,25,0,-25
10892,1,0,5,0,-5
10893,0,0,37,0,-37
10894,0,0,4,0,-4
10895,0,0,5,0,-5
10896,1,0,41,0,-41
10897,1,1,215,1549,1334
10898,1,0,70,0,-70
10899,1,1,941,1308,367
10900,0,0,59,0,-59
10901,0,0,10,0,-10
10902,1,0,30,0,-30
10903,1,0,12,0,-12
10904,1,0,20,0,-20
10905,1,1,283,1382,1099
10906,0,0,75,0,-75
10907,1,1,1133,1395,262
10908,0,0,26,0,-26
10909,1,1,226,1576,1350
10910,1,1,43,3380,3337
10911,0,0,41,0,-41
10912,0,0,72,0,-72
10913,0,0,156,0,-156
10914,0,0,0,0,0
10915,1,0,2,0,-2
10916,0,0,45,0,-45
10917,0,0,2,0,-2
10918,1,1,1301,2292,991
10919,1,1,53,1265,1212
10920,0,0,125,0,-125
10921,1,1,385,1715,1330
10922,0,0,16,0,-16
10923,0,0,25,0,-25
10924,0,0,43,0,-43
10925,1,0,39,0,-39
10926,1,0,23,0,-23
10927,0,0,118,0,-118
10928,0,0,45,0,-45
10929,1,1,674,1232,558
10930,1,1,122,1243,1121
10931,1,0,12,0,-12
10932,1,0,130,0,-130
10933,1,1,177,1294,1117
10934,1,1,150,1611,1461
10935,0,0,172,0,-172
10936,0,0,20,0,-20
10937,1,0,23,0,-23
10938,0,0,48,0,-48
10939,1,0,36,0,-36
10940,0,0,10,0,-10
10941,1,0,12,0,-12
10942,0,0,38,0,-38
10943,1,0,93,0,-93
10944,0,0,41,0,-41
10945,1,0,13,0,-13
10946,1,1,468,1434,966
10947,0,0,75,0,-75
10948,0,0,66,0,-66
10949,0,0,15,0,-15
10950,1,1,584,1782,1198
10951,1,0,113,0,-113
10952,0,0,224,0,-224
10953,1,1,174,1375,1201
10954,1,0,18,0,-18
10955,0,0,0,0,0
10956,0,0,214,0,-214
10957,0,0,1,0,-1
10958,1,0,35,0,-35
10959,0,0,126,0,-126
10960,1,1,1799,1226,-573
10961,1,0,97,0,-97
10962,1,1,317,1638,1321
10963,1,1,1293,1348,55
10964,1,1,626,1405,779
10965,1,1,423,1854,1431
10966,1,0,33,0,-33
10967,1,1,333,1330,997
10968,0,0,62,0,-62
10969,0,0,170,0,-170
10970,1,0,66,0,-66
10971,1,0,70,0,-70
10972,1,0,46,0,-46
10973,1,0,38,0,-38
10974,1,1,538,1611,1073
10975,1,0,33,0,-33
10976,0,0,163,0,-163
10977,1,0,66,0,-66
10978,1,1,38,2011,1973
10979,1,1,858,1377,519
10980,0,0,82,0,-82
10981,1,0,16,0,-16
10982,1,0,3,0,-3
10983,1,0,61,0,-61
10984,1,0,85,0,-85
10985,1,0,12,0,-12
10986,1,1,90,2409,2319
10987,1,1,237,1887,1650
10988,1,0,56,0,-56
10989,0,0,36,0,-36
10990,1,0,199,0,-199
10991,1,1,418,1351,933
10992,0,0,209,0,-209
10993,0,0,116,0,-116
10994,1,1,1150,1369,219
10995,0,0,97,0,-97
10996,0,0,135,0,-135
10997,1,0,87,0,-87
10998,1,0,62,0,-62
10999,1,0,22,0,-22
11000,1,1,1244,1847,603
11001,1,0,53,0,-53
11002,1,0,10,0,-10
11003,0,0,22,0,-22
11004,0,0,257,0,-257
11005,0,0,1,0,-1
11006,0,0,16,0,-16
11007,1,1,766,1232,466
11008,1,0,26,0,-26
11009,1,0,47,0,-47
11010,1,0,101,0,-101
11011,1,0,16,0,-16
11012,0,0,8,0,-8
11013,1,0,7,0,-7
11014,1,1,997,1330,333
11015,0,0,15,0,-15
11016,1,0,20,0,-20
11017,1,0,75,0,-75
11018,1,1,88,1576,1488
11019,1,1,646,1238,592
11020,1,0,31,0,-31
11021,1,0,17,0,-17
11022,0,0,25,0,-25
11023,1,0,6,0,-6
11024,0,0,115,0,-115
11025,0,0,14,0,-14
11026,1,1,409,1427,1018
11027,0,0,32,0,-32
11028,1,1,414,2929,2515
11029,1,1,643,2112,1469
11030,0,0,19,0,-19
11031,1,1,868,1272,404
11032,0,0,3,0,-3
11033,0,0,55,0,-55
11034,1,0,61,0,-61
11035,0,0,41,0,-41
11036,0,0,61,0,-61
11037,0,0,46,0,-46
11038,1,1,249,1292,1043
11039,0,0,4,0,-4
11040,1,1,561,1977,1416
11041,1,1,442,1207,765
11042,1,1,454,1495,1041
11043,1,0,42,0,-42
11044,1,0,24,0,-24
11045,0,0,116,0,-116
11046,0,0,15,0,-15
11047,0,0,77,0,-77
11048,1,1,408,1371,963
11049,1,1,245,1345,1100
11050,0,0,89,0,-89
11051,0,0,2,0,-2
11052,1,0,30,0,-30
11053,0,0,98,0,-98
11054,1,1,369,2230,1861
11055,0,0,80,0,-80
11056,0,0,12,0,-12
11057,1,0,19,0,-19
11058,1,1,471,1880,1409
11059,1,1,776,1559,783
11060,0,0,1,0,-1
11061,1,1,168,1526,1358
11062,1,0,42,0,-42
11063,0,0,50,0,-50
11064,0,0,62,0,-62
11065,1,1,162,1737,1575
11066,1,0,16,0,-16
11067,1,0,1,0,-1
11068,1,1,143,2550,2407
11069,1,0,7,0,-7
11070,1,1,661,1344,683
11071,1,1,352,1213,861
11072,1,1,286,1698,1412
11073,0,0,11,0,-11
11074,1,1,569,2222,1653
11075,0,0,4,0,-4
11076,1,1,887,1625,738
11077,1,0,15,0,-15
11078,1,0,98,0,-98
11079,1,1,230,1419,1189
11080,0,0,10,0,-10
11081,0,0,3,0,-3
11082,1,1,293,1217,924
11083,1,0,11,0,-11
11084,0,0,26,0,-26
11085,1,0,37,0,-37
11086,0,0,32,0,-32
11087,0,0,29,0,-29
11088,0,0,74,0,-74
11089,1,1,224,3870,3646
11090,0,0,24,0,-24
11091,1,0,87,0,-87
11092,1,0,6,0,-6
11093,0,0,98,0,-98
11094,1,1,1412,1608,196
11095,0,0,12,0,-12
11096,1,1,205,1921,1716
11097,0,0,24,0,-24
11098,1,1,315,1837,1522
11099,1,1,818,1526,708
11100,0,0,167,0,-167
11101,1,1,511,2640,2129
11102,1,0,32,0,-32
11103,0,0,75,0,-75
11104,0,0,6,0,-6
11105,0,0,8,0,-8
11106,1,1,153,1301,1148
11107,1,0,41,0,-41
11108,1,0,45,0,-45
11109,1,1,578,1417,839
11110,0,0,88,0,-88
11111,0,0,58,0,-58
11112,1,0,39,0,-39
11113,0,0,43,0,-43
11114,0,0,55,0,-55
11115,1,0,52,0,-52
11116,0,0,20,0,-20
11117,0,0,42,0,-42
11118,0,0,109,0,-109
11119,0,0,16,0,-16
11120,1,1,359,2503,2144
11121,1,1,628,1243,615
11122,0,0,15,0,-15
11123,0,0,8,0,-8
11124,0,0,48,0,-48
11125,0,0,119,0,-119
11126,0,0,4,0,-4
11127,1,0,39,0,-39
11128,0,0,9,0,-9
11129,1,1,148,3113,2965
11130,1,0,64,0,-64
11131,1,0,0,0,0
11132,0,0,29,0,-29
11133,1,0,128,0,-128
11134,0,0,33,0,-33
11135,0,0,76,0,-76
11136,1,0,13,0,-13
11137,1,1,1036,1600,564
11138,1,1,549,1277,728
11139,0,0,3,0,-3
11140,0,0,62,0,-62
11141,0,0,21,0,-21
11142,0,0,7,0,-7
11143,1,1,378,1250,872
11144,1,1,551,2673,2122
11145,1,1,177,1369,1192
11146,0,0,30,0,-30
11147,1,1,82,1604,1522
11148,1,1,217,1560,1343
11149,1,0,2,0,-2
11150,0,0,69,0,-69
11151,0,0,23,0,-23
11152,1,1,36,1468,1432
11153,0,0,55,0,-55
11154,1,0,65,0,-65
11155,1,0,29,0,-29
11156,1,1,470,1374,904
11157,0,0,220,0,-220
11158,1,1,114,1426,1312
11159,0,0,15,0,-15
11160,0,0,8,0,-8
11161,0,0,4,0,-4
11162,0,0,16,0,-16
11163,0,0,93,0,-93
11164,1,0,272,0,-272
11165,1,0,21,0,-21
11166,0,0,15,0,-15
11167,0,0,64,0,-64
11168,0,0,29,0,-29
11169,1,0,59,0,-59
11170,0,0,44,0,-44
11171,0,0,72,0,-72
11172,1,0,23,0,-23
11173,1,1,2559,2666,107
11174,1,0,50,0,-50
11175,0,0,11,0,-11
11176,1,0,64,0,-64
11177,1,1,106,1203,1097
11178,1,1,664,1379,715
11179,0,0,93,0,-93
11180,0,0,14,0,-14
11181,0,0,32,0,-32
11182,0,0,191,0,-191
11183,1,1,848,1240,392
11184,0,0,50,0,-50
11185,0,0,42,0,-42
11186,1,0,27,0,-27
11187,0,0,6,0,-6
11188,1,1,423,1538,1115
11189,0,0,109,0,-109
11190,0,0,58,0,-58
11191,0,0,47,0,-47
11192,0,0,22,0,-22
11193,1,0,107,0,-107
11194,1,1,90,1605,1515
11195,1,1,215,1956,1741
11196,1,0,154,0,-154
11197,0,0,41,0,-41
11198,1,0,46,0,-46
11199,1,1,1374,1391,17
11200,0,0,11,0,-11
11201,0,0,108,0,-108
11202,1,1,42,2627,2585
11203,1,1,261,1456,1195
11204,1,0,29,0,-29
11205,0,0,75,0,-75
11206,0,0,14,0,-14
11207,1,1,1527,1567,40
11208,1,1,715,2442,1727
11209,0,0,25,0,-25
11210,0,0,14,0,-14
11211,1,0,55,0,-55
11212,1,1,90,1476,1386
11213,1,1,266,1345,1079
11214,1,1,629,1284,655
11215,0,0,61,0,-61
11216,0,0,5,0,-5
11217,1,0,8,0,-8
11218,1,0,48,0,-48
11219,1,0,8,0,-8
11220,0,0,106,0,-106
11221,1,1,1010,1476,466
11222,1,0,251,0,-251
11223,0,0,104,0,-104
11224,1,0,34,0,-34
11225,0,0,23,0,-23
11226,0,0,47,0,-47
11227,1,0,43,0,-43
11228,0,0,160,0,-160
11229,0,0,10,0,-10
11230,0,0,22,0,-22
11231,1,1,707,1433,726
11232,0,0,54,0,-54
11233,0,0,41,0,-41
11234,1,0,40,0,-40
11235,1,1,375,1493,1118
11236,0,0,6,0,-6
11237,0,0,19,0,-19
11238,0,0,26,0,-26
11239,1,1,401,1289,888
11240,0,0,16,0,-16
11241,0,0,1,0,-1
11242,1,0,8,0,-8
11243,1,1,431,1225,794
11244,1,0,31,0,-31
11245,0,0,34,0,-34
11246,0,0,93,0,-93
11247,1,1,126,1489,1363
11248,0,0,18,0,-18
11249,0,0,11,0,-11
11250,0,0,11,0,-11
11251,1,0,105,0,-105
11252,1,0,31,0,-31
11253,0,0,86,0,-86
11254,1,0,90,0,-90
11255,1,0,6,0,-6
11256,0,0,85,0,-85
11257,0,0,6,0,-6
11258,1,1,229,1200,971
11259,0,0,9,0,-9
11260,0,0,113,0,-113
11261,1,0,59,0,-59
11262,1,0,18,0,-18
11263,1,0,4,0,-4
11264,0,0,17,0,-17
11265,0,0,159,0,-159
11266,1,1,473,1318,845
11267,0,0,205,0,-205
11268,1,1,426,1422,996
11269,1,0,12,0,-12
11270,0,0,52,0,-52
11271,1,0,39,0,-39
11272,1,0,44,0,-44
11273,1,0,54,0,-54
11274,1,0,166,0,-166
11275,0,0,46,0,-46
11276,0,0,70,0,-70
11277,1,1,562,1257,695
11278,0,0,3,0,-3
11279,1,0,98,0,-98
11280,0,0,23,0,-23
11281,0,0,6,0,-6
11282,1,0,32,0,-32
11283,1,0,57,0,-57
11284,1,0,22,0,-22
11285,0,0,19,0,-19
11286,1,0,7,0,-7
11287,1,1,65,1326,1261
11288,1,0,2,0,-2
11289,0,0,78,0,-78
11290,0,0,0,0,0
11291,1,0,60,0,-60
11292,1,0,1,0,-1
11293,0,0,4,0,-4
11294,0,0,70,0,-70
11295,0,0,12,0,-12
11296,1,0,70,0,-70
11297,1,0,14,0,-14
11298,1,0,109,0,-109
11299,1,1,795,3420,2625
11300,1,1,852,2311,1459
11301,0,0,49,0,-49
11302,0,0,31,0,-31
11303,1,1,344,1318,974
11304,0,0,69,0,-69
11305,1,1,837,1424,587
11306,0,0,64,0,-64
11307,1,1,913,1334,421
11308,1,1,117,1214,1097
11309,1,1,2439,1219,-1220
11310,0,0,27,0,-27
11311,1,0,16,0,-16
11312,0,0,34,0,-34
11313,0,0,56,0,-56
11314,1,0,41,0,-41
11315,0,0,0,0,0
11316,1,1,1342,1971,629
11317,1,0,53,0,-53
11318,0,0,11,0,-11
11319,0,0,10,0,-10
11320,0,0,104,0,-104
11321,1,0,36,0,-36
11322,0,0,67,0,-67
11323,0,0,79,0,-79
11324,1,1,132,2268,2136
11325,1,1,114,1484,1370
11326,1,0,14,0,-14
11327,1,1,286,1677,1391
11328,0,0,0,0,0
11329,0,0,17,0,-17
11330,1,0,3,0,-3
11331,0,0,72,0,-72
11332,1,0,3,0,-3
11333,1,0,57,0,-57
11334,1,1,419,1314,895
11335,1,1,147,1578,1431
11336,1,1,535,2467,1932
11337,1,0,4,0,-4
11338,1,0,145,0,-145
11339,0,0,0,0,0
11340,1,1,296,2286,1990
11341,1,0,79,0,-79
11342,1,0,163,0,-163
11343,1,1,566,1553,987
11344,1,1,294,2482,2188
11345,1,0,4,0,-4
11346,1,1,1375,1262,-113
11347,0,0,3,0,-3
11348,1,1,100,1257,1157
11349,1,1,402,1292,890
11350,1,1,128,1211,1083
11351,0,0,6,0,-6
11352,1,0,2,0,-2
11353,1,1,621,1275,654
11354,0,0,16,0,-16
11355,1,0,2,0,-2
11356,1,0,11,0,-11
11357,0,0,73,0,-73
11358,0,0,94,0,-94
11359,1,1,1509,1257,-252
11360,0,0,49,0,-49
11361,1,1,145,1207,1062
11362,1,1,1386,1299,-87
11363,0,0,45,0,-45
11364,1,0,70,0,-70
11365,0,0,62,0,-62
11366,1,1,430,1383,953
11367,1,0,79,0,-79
11368,1,0,13,0,-13
11369,0,0,109,0,-109
11370,0,0,5,0,-5
11371,0,0,121,0,-121
11372,1,0,86,0,-86
11373,0,0,22,0,-22
11374,1,1,637,1294,657
11375,1,1,372,1278,906
11376,0,0,17,0,-17
11377,0,0,39,0,-39
11378,1,1,370,1254,884
11379,1,1,864,1357,493
11380,1,1,330,1576,1246
11381,1,0,89,0,-89
11382,1,0,5,0,-5
11383,1,1,114,1319,1205
11384,0,0,12,0,-12
11385,0,0,22,0,-22
11386,0,0,57,0,-57
11387,0,0,6,0,-6
11388,1,0,9,0,-9
11389,0,0,32,0,-32
11390,0,0,34,0,-34
11391,0,0,12,0,-12
11392,0,0,46,0,-46
11393,0,0,50,0,-50
11394,1,1,305,1468,1163
11395,1,1,207,2186,1979
11396,0,0,94,0,-94
11397,0,0,22,0,-22
11398,1,0,0,0,0
11399,0,0,6,0,-6
11400,0,0,8,0,-8
11401,0,0,53,0,-53
11402,1,0,43,0,-43
11403,0,0,81,0,-81
11404,1,1,217,1370,1153
11405,0,0,11,0,-11
11406,1,1,204,1250,1046
11407,1,1,142,1376,1234
11408,1,1,307,1246,939
11409,1,0,23,0,-23
11410,0,0,3,0,-3
11411,1,0,5,0,-5
11412,0,0,0,0,0
11413,0,0,65,0,-65
11414,1,0,46,0,-46
11415,0,0,102,0,-102
11416,1,1,82,1649,1567
11417,0,0,45,0,-45
11418,0,0,10,0,-10
11419,0,0,61,0,-61
11420,1,0,136,0,-136
11421,0,0,18,0,-18
11422,0,0,18,0,-18
11423,0,0,37,0,-37
11424,0,0,111,0,-111
11425,0,0,21,0,-21
11426,1,0,75,0,-75
11427,1,1,54,1536,1482
11428,0,0,113,0,-113
11429,0,0,89,0,-89
11430,1,1,342,1262,920
11431,0,0,71,0,-71
11432,1,1,215,1347,1132
11433,1,1,529,1491,962
11434,1,1,109,1340,1231
11435,0,0,16,0,-16
11436,1,1,1007,1210,203
11437,0,0,23,0,-23
11438,1,1,370,1435,1065
11439,1,1,77,1275,1198
11440,1,0,125,0,-125
11441,0,0,42,0,-42
11442,1,1,666,1311,645
11443,0,0,23,0,-23
11444,0,0,3,0,-3
11445,0,0,16,0,-16
11446,0,0,2,0,-2
11447,0,0,88,0,-88
11448,1,1,653,1476,823
11449,1,0,10,0,-10
11450,0,0,64,0,-64
11451,1,0,66,0,-66
11452,0,0,21,0,-21
11453,0,0,15,0,-15
11454,1,0,39,0,-39
11455,1,0,68,0,-68
11456,1,0,10,0,-10
11457,1,0,9,0,-9
11458,1,0,6,0,-6
11459,0,0,62,0,-62
11460,1,0,58,0,-58
11461,0,0,30,0,-30
11462,1,0,4,0,-4
11463,0,0,61,0,-61
11464,1,0,90,0,-90
11465,1,0,57,0,-57
11466,1,1,203,1500,1297
11467,0,0,14,0,-14
11468,0,0,55,0,-55
11469,1,0,1,0,-1
11470,1,1,345,1754,1409
11471,1,1,788,1238,450
11472,0,0,47,0,-47
11473,1,1,126,1480,1354
11474,1,1,207,1359,1152
11475,1,0,17,0,-17
11476,1,1,249,1207,958
11477,0,0,17,0,-17
11478,1,0,61,0,-61
11479,1,0,268,0,-268
11480,0,0,22,0,-22
11481,0,0,310,0,-310
11482,1,0,59,0,-59
11483,1,1,920,1503,583
11484,0,0,40,0,-40
11485,1,1,180,1437,1257
11486,0,0,45,0,-45
11487,0,0,106,0,-106
11488,0,0,75,0,-75
11489,1,1,1300,1264,-36
11490,0,0,24,0,-24
11491,1,1,229,1251,1022
11492,0,0,119,0,-119
11493,1,1,187,1269,1082
11494,1,1,88,1269,1181
11495,1,1,295,1300,1005
11496,1,0,17,0,-17
11497,1,1,216,1779,1563
11498,1,1,134,1955,1821
11499,1,0,75,0,-75
11500,1,0,75,0,-75
11501,0,0,95,0,-95
11502,1,0,16,0,-16
11503,1,0,41,0,-41
11504,1,0,7,0,-7
11505,1,1,346,1782,1436
11506,0,0,2,0,-2
11507,0,0,10,0,-10
11508,1,0,22,0,-22
11509,0,0,169,0,-169
11510,0,0,90,0,-90
11511,1,0,6,0,-6
11512,1,1,173,1213,1040
11513,0,0,37,0,-37
11514,1,1,387,1293,906
11515,1,0,30,0,-30
11516,1,0,16,0,-16
11517,0,0,1,0,-1
11518,0,0,19,0,-19
11519,1,1,969,1221,252
11520,0,0,21,0,-21
11521,1,1,574,1689,1115
11522,0,0,32,0,-32
11523,1,0,41,0,-41
11524,0,0,1,0,-1
11525,1,0,47,0,-47
11526,1,1,227,1537,1310
11527,0,0,63,0,-63
11528,1,1,1312,1393,81
11529,1,0,16,0,-16
11530,1,1,339,1213,874
11531,0,0,48,0,-48
11532,1,0,29,0,-29
11533,1,1,872,1211,339
11534,0,0,3,0,-3
11535,1,0,13,0,-13
11536,1,0,66,0,-66
11537,1,0,98,0,-98
11538,1,0,99,0,-99
11539,1,1,553,1419,866
11540,1,1,281,1674,1393
11541,1,1,183,1201,1018
11542,0,0,15,0,-15
11543,0,0,19,0,-19
11544,0,0,51,0,-51
11545,0,0,0,0,0
11546,1,0,30,0,-30
11547,1,0,18,0,-18
11548,1,0,12,0,-12
11549,0,0,9,0,-9
11550,1,0,153,0,-153
11551,1,1,695,1311,616
11552,0,0,68,0,-68
11553,0,0,5,0,-5
11554,0,0,9,0,-9
11555,0,0,3,0,-3
11556,1,1,481,1689,1208
11557,1,1,709,1450,741
11558,0,0,149,0,-149
11559,0,0,17,0,-17
11560,1,1,402,1457,1055
11561,0,0,96,0,-96
11562,0,0,47,0,-47
11563,1,1,194,1354,1160
11564,1,1,646,1336,690
11565,1,1,540,2690,2150
11566,1,1,334,1729,1395
11567,0,0,81,0,-81
11568,1,1,224,2195,1971
11569,1,0,11,0,-11
11570,1,0,12,0,-12
11571,1,1,90,1670,1580
11572,1,0,18,0,-18
11573,1,1,1553,1237,-316
11574,1,0,79,0,-79
11575,1,1,1475,1683,208
11576,0,0,35,0,-35
11577,1,1,447,4318,3871
11578,0,0,163,0,-163
11579,1,1,1855,1252,-603
11580,0,0,130,0,-130
11581,0,0,52,0,-52
11582,0,0,3,0,-3
11583,1,0,3,0,-3
11584,1,1,1109,1296,187
11585,1,0,5,0,-5
11586,1,1,528,1200,672
11587,1,0,7,0,-7
11588,1,1,232,1242,1010
11589,1,0,1,0,-1
11590,0,0,1,0,-1
11591,1,1,915,1729,814
11592,0,0,27,0,-27
11593,1,1,380,1425,1045
11594,0,0,6,0,-6
11595,1,1,51,1355,1304
11596,0,0,8,0,-8
11597,1,0,78,0,-78
11598,1,1,1863,1437,-426
11599,0,0,45,0,-45
11600,1,1,615,1266,651
11601,1,1,165,1326,1161
11602,0,0,28,0,-28
11603,0,0,73,0,-73
11604,1,1,113,1771,1658
11605,0,0,14,0,-14
11606,1,0,18,0,-18
11607,1,0,24,0,-24
11608,1,0,79,0,-79
11609,0,0,11,0,-11
11610,1,0,22,0,-22
11611,0,0,40,0,-40
11612,1,1,200,1455,1255
11613,1,1,408,2220,1812
11614,0,0,27,0,-27
11615,1,1,211,1209,998
11616,1,1,299,1868,1569
11617,1,0,52,0,-52
11618,0,0,7,0,-7
11619,1,0,60,0,-60
11620,0,0,42,0,-42
11621,0,0,37,0,-37
11622,1,1,482,1353,871
11623,1,0,146,0,-146
11624,0,0,67,0,-67
11625,1,0,23,0,-23
11626,0,0,12,0,-12
11627,0,0,12,0,-12
11628,0,0,80,0,-80
11629,1,0,56,0,-56
11630,1,1,425,1250,825
11631,1,0,27,0,-27
11632,1,1,212,1256,1044
11633,0,0,194,0,-194
11634,1,0,13,0,-13
11635,1,0,12,0,-12
11636,1,1,585,1576,991
11637,1,1,560,1566,1006
11638,1,0,79,0,-79
11639,1,1,832,1648,816
11640,1,1,196,1411,1215
11641,1,1,162,1907,1745
11642,1,1,930,1203,273
11643,0,0,72,0,-72
11644,0,0,100,0,-100
11645,1,0,118,0,-118
11646,0,0,65,0,-65
11647,0,0,52,0,-52
11648,1,0,15,0,-15
11649,1,1,87,2122,2035
11650,1,1,1007,1394,387
11651,0,0,41,0,-41
11652,0,0,37,0,-37
11653,1,1,351,1548,1197
11654,0,0,13,0,-13
11655,1,1,475,1633,1158
11656,1,1,539,1227,688
11657,1,0,21,0,-21
11658,0,0,0,0,0
11659,0,0,9,0,-9
11660,1,0,47,0,-47
11661,1,1,356,1892,1536
11662,0,0,74,0,-74
11663,0,0,62,0,-62
11664,1,1,229,1218,989
11665,1,1,299,1219,920
11666,1,1,16,1510,1494
11667,0,0,317,0,-317
11668,0,0,57,0,-57
11669,0,0,153,0,-153
11670,1,0,50,0,-50
11671,1,0,44,0,-44
11672,1,0,32,0,-32
11673,1,1,51,1824,1773
11674,0,0,17,0,-17
11675,0,0,111,0,-111
11676,0,0,3,0,-3
11677,0,0,182,0,-182
11678,1,0,41,0,-41
11679,1,0,49,0,-49
11680,0,0,17,0,-17
11681,0,0,69,0,-69
11682,1,0,13,0,-13
11683,0,0,90,0,-90
11684,1,0,48,0,-48
11685,0,0,118,0,-118
11686,0,0,100,0,-100
11687,1,0,16,0,-16
11688,1,1,111,1872,1761
11689,0,0,13,0,-13
11690,0,0,90,0,-90
11691,1,1,112,1712,1600
11692,0,0,19,0,-19
11693,1,1,132,1456,1324
11694,0,0,7,0,-7
11695,1,1,225,1799,1574
11696,0,0,20,0,-20
11697,0,0,47,0,-47
11698,0,0,193,0,-193
11699,0,0,201,0,-201
11700,1,1,859,1657,798
11701,1,1,38,3683,3645
11702,0,0,9,0,-9
11703,0,0,5,0,-5
11704,0,0,3,0,-3
11705,0,0,137,0,-137
11706,1,1,182,1227,1045
11707,1,0,41,0,-41
11708,1,0,7,0,-7
11709,0,0,34,0,-34
11710,0,0,164,0,-164
11711,1,0,8,0,-8
11712,1,0,15,0,-15
11713,0,0,27,0,-27
11714,1,0,59,0,-59
11715,0,0,0,0,0
11716,1,1,101,1591,1490
11717,1,0,129,0,-129
11718,0,0,37,0,-37
11719,1,1,1426,1377,-49
11720,1,0,71,0,-71
11721,1,1,208,4407,4199
11722,0,0,137,0,-137
11723,1,1,513,1494,981
11724,1,0,61,0,-61
11725,1,0,50,0,-50
11726,0,0,25,0,-25
11727,0,0,52,0,-52
11728,1,1,478,1356,878
11729,0,0,47,0,-47
11730,0,0,8,0,-8
11731,0,0,49,0,-49
11732,1,1,657,1455,798
11733,0,0,48,0,-48
11734,0,0,79,0,-79
11735,1,0,38,0,-38
11736,0,0,0,0,0
11737,0,0,99,0,-99
11738,1,0,92,0,-92
11739,1,1,191,1201,1010
11740,1,0,41,0,-41
11741,0,0,121,0,-121
11742,0,0,105,0,-105
11743,1,1,85,1303,1218
11744,0,0,117,0,-117
11745,1,0,42,0,-42
11746,0,0,22,0,-22
11747,0,0,19,0,-19
11748,1,1,100,1262,1162
11749,1,1,306,1268,962
11750,1,1,626,1531,905
11751,0,0,2,0,-2
11752,1,1,677,1429,752
11753,1,0,12,0,-12
11754,0,0,13,0,-13
11755,0,0,106,0,-106
11756,1,0,38,0,-38
11757,1,1,436,1223,787
11758,0,0,7,0,-7
11759,0,0,262,0,-262
11760,1,0,137,0,-137
11761,0,0,15,0,-15
11762,0,0,5,0,-5
11763,0,0,12,0,-12
11764,1,0,3,0,-3
11765,1,1,620,1201,581
11766,0,0,110,0,-110
11767,1,1,1240,1247,7
11768,1,0,54,0,-54
11769,1,0,50,0,-50
11770,0,0,75,0,-75
11771,1,1,352,1635,1283
11772,0,0,127,0,-127
11773,1,1,110,1280,1170
11774,0,0,17,0,-17
11775,0,0,6,0,-6
11776,0,0,19,0,-19
11777,1,1,36,1420,1384
11778,0,0,39,0,-39
11779,0,0,11,0,-11
11780,1,1,296,1360,1064
11781,0,0,5,0,-5
11782,0,0,45,0,-45
11783,1,0,12,0,-12
11784,0,0,60,0,-60
11785,1,1,882,1281,399
11786,1,1,1570,1200,-370
11787,1,1,265,1307,1042
11788,1,0,33,0,-33
11789,0,0,149,0,-149
11790,0,0,40,0,-40
11791,1,1,98,1223,1125
11792,1,0,8,0,-8
11793,0,0,28,0,-28
11794,1,0,1,0,-1
11795,1,0,25,0,-25
11796,0,0,5,0,-5
11797,0,0,3,0,-3
11798,1,0,45,0,-45
11799,0,0,67,0,-67
11800,1,1,145,1792,1647
11801,1,1,575,2376,1801
11802,0,0,128,0,-128
11803,1,0,54,0,-54
11804,1,1,698,1433,735
11805,0,0,5,0,-5
11806,1,1,956,2327,1371
11807,1,0,12,0,-12
11808,1,0,34,0,-34
11809,1,1,153,1284,1131
11810,0,0,13,0,-13
11811,1,0,135,0,-135
11812,0,0,111,0,-111
11813,1,1,72,1391,1319
11814,0,0,31,0,-31
11815,1,0,33,0,-33
11816,1,0,202,0,-202
11817,0,0,92,0,-92
11818,0,0,47,0,-47
11819,1,1,1179,1537,358
11820,1,0,13,0,-13
11821,0,0,3,0,-3
11822,1,0,38,0,-38
11823,0,0,18,0,-18
11824,0,0,21,0,-21
11825,0,0,9,0,-9
11826,0,0,169,0,-169
11827,1,0,77,0,-77
11828,1,0,80,0,-80
11829,0,0,12,0,-12
11830,1,0,35,0,-35
11831,0,0,31,0,-31
11832,0,0,120,0,-120
11833,1,1,456,1264,808
11834,0,0,45,0,-45
11835,1,0,1,0,-1
11836,1,1,790,2209,1419
11837,1,0,115,0,-115
11838,1,1,641,1529,888
11839,0,0,37,0,-37
11840,0,0,95,0,-95
11841,0,0,0,0,0
11842,0,0,84,0,-84
11843,0,0,24,0,-24
11844,0,0,50,0,-50
11845,1,0,25,0,-25
11846,1,0,31,0,-31
11847,0,0,45,0,-45
11848,0,0,75,0,-75
11849,1,0,48,0,-48
11850,1,0,64,0,-64
11851,0,0,10,0,-10
11852,0,0,45,0,-45
11853,1,0,65,0,-65
11854,1,1,318,1457,1139
11855,1,0,17,0,-17
11856,1,0,22,0,-22
11857,1,1,491,1296,805
11858,1,1,182,1218,1036
11859,1,1,4228,1200,-3028
11860,0,0,77,0,-77
11861,1,0,0,0,0
11862,1,1,1089,1696,607
11863,0,0,100,0,-100
11864,1,1,1119,1384,265
11865,1,1,131,1628,1497
11866,0,0,40,0,-40
11867,0,0,18,0,-18
11868,0,0,60,0,-60
11869,0,0,119,0,-119
11870,1,0,10,0,-10
11871,1,1,689,1256,567
11872,0,0,54,0,-54
11873,0,0,48,0,-48
11874,1,1,128,1427,1299
11875,1,1,230,1207,977
11876,0,0,24,0,-24
11877,1,1,1142,1860,718
11878,1,1,359,1237,878
11879,1,0,11,0,-11
11880,1,1,244,1361,1117
11881,1,0,0,0,0
11882,1,0,35,0,-35
11883,0,0,73,0,-73
11884,1,0,16,0,-16
11885,1,1,283,1861,1578
11886,0,0,82,0,-82
11887,1,1,438,1342,904
11888,1,0,122,0,-122
11889,0,0,4,0,-4
11890,1,1,276,1601,1325
11891,1,0,152,0,-152
11892,0,0,137,0,-137
11893,1,0,113,0,-113
11894,1,1,582,1584,1002
11895,0,0,59,0,-59
11896,1,1,332,1276,944
11897,1,1,356,1859,1503
11898,0,0,145,0,-145
11899,0,0,12,0,-12
11900,1,0,46,0,-46
11901,0,0,99,0,-99
11902,1,1,731,1270,539
11903,1,1,283,1329,1046
11904,0,0,4,0,-4
11905,1,0,14,0,-14
11906,1,0,0,0,0
11907,0,0,89,0,-89
11908,0,0,121,0,-121
11909,0,0,5,0,-5
11910,0,0,13,0,-13
11911,1,1,466,1768,1302
11912,1,0,50,0,-50
11913,1,0,26,0,-26
11914,0,0,13,0,-13
11915,1,1,379,1601,1222
11916,1,1,1747,1202,-545
11917,1,1,303,1285,982
11918,1,0,24,0,-24
11919,0,0,60,0,-60
11920,0,0,171,0,-171
11921,1,0,221,0,-221
11922,0,0,82,0,-82
11923,1,1,193,1660,1467
11924,1,1,748,1746,998
11925,1,0,16,0,-16
11926,1,1,926,1333,407
11927,1,0,183,0,-183
11928,1,1,701,1363,662
11929,0,0,62,0,-62
11930,1,0,77,0,-77
11931,1,1,721,2220,1499
11932,1,1,85,1609,1524
11933,1,1,79,1764,1685
11934,0,0,27,0,-27
11935,1,1,410,1581,1171
11936,0,0,54,0,-54
11937,1,1,325,1333,1008
11938,1,1,1861,1398,-463
11939,1,0,4,0,-4
11940,0,0,8,0,-8
11941,1,0,55,0,-55
11942,0,0,6,0,-6
11943,0,0,14,0,-14
11944,1,0,221,0,-221
11945,1,1,349,1495,1146
11946,1,0,53,0,-53
11947,1,0,77,0,-77
11948,1,0,51,0,-51
11949,0,0,28,0,-28
11950,0,0,62,0,-62
11951,0,0,5,0,-5
11952,1,0,134,0,-134
11953,1,1,1085,1364,279
11954,1,1,408,1287,879
11955,1,1,700,1506,806
11956,1,1,278,1324,1046
11957,1,1,1387,1480,93
11958,1,1,384,1973,1589
11959,0,0,27,0,-27
11960,1,1,97,1375,1278
11961,1,1,246,1286,1040
11962,0,0,48,0,-48
11963,1,1,1021,1222,201
11964,1,0,25,0,-25
11965,1,1,163,1650,1487
11966,0,0,63,0,-63
11967,0,0,12,0,-12
11968,1,0,1,0,-1
11969,1,1,144,1234,1090
11970,1,1,198,1441,1243
11971,1,0,24,0,-24
11972,1,1,1311,1211,-100
11973,0,0,188,0,-188
11974,1,1,79,2472,2393
11975,1,1,977,1440,463
11976,1,1,521,1200,679
11977,1,0,33,0,-33
11978,0,0,12,0,-12
11979,0,0,123,0,-123
11980,0,0,113,0,-113
11981,0,0,74,0,-74
11982,1,0,215,0,-215
11983,1,1,236,1214,978
11984,0,0,41,0,-41
11985,1,1,615,1413,798
11986,0,0,31,0,-31
11987,1,0,55,0,-55
11988,1,1,854,1574,720
11989,0,0,92,0,-92
11990,1,1,782,1415,633
11991,1,0,1,0,-1
11992,0,0,40,0,-40
11993,0,0,1,0,-1
11994,0,0,10,0,-10
11995,0,0,3,0,-3
11996,1,0,98,0,-98
11997,1,1,290,1351,1061
11998,1,1,243,1357,1114
11999,1,0,142,0,-142
12000,1,0,55,0,-55
12001,1,1,424,1425,1001
12002,0,0,9,0,-9
12003,1,1,82,1423,1341
12004,0,0,302,0,-302
12005,1,0,21,0,-21
12006,0,0,3,0,-3
12007,0,0,62,0,-62
12008,0,0,1,0,-1
12009,1,1,13,1221,1208
12010,1,1,964,1402,438
12011,1,1,260,1318,1058
12012,1,0,105,0,-105
12013,0,0,26,0,-26
12014,1,1,871,1366,495
12015,1,0,49,0,-49
12016,1,1,414,1681,1267
12017,1,0,16,0,-16
12018,1,0,6,0,-6
12019,0,0,2,0,-2
12020,1,1,196,1340,1144
12021,1,1,1762,2128,366
12022,1,1,858,1314,456
12023,1,1,410,1356,946
12024,1,0,4,0,-4
12025,0,0,21,0,-21
12026,0,0,0,0,0
12027,1,1,1229,1203,-26
12028,0,0,25,0,-25
12029,0,0,54,0,-54
12030,1,0,58,0,-58
12031,0,0,19,0,-19
12032,1,1,592,2252,1660
12033,0,0,30,0,-30
12034,0,0,43,0,-43
12035,0,0,35,0,-35
12036,1,0,99,0,-99
12037,1,1,1102,1297,195
12038,1,1,558,1276,718
12039,1,0,40,0,-40
12040,1,0,174,0,-174
12041,1,0,50,0,-50
12042,1,0,13,0,-13
12043,1,1,21,1418,1397
12044,0,0,2,0,-2
12045,1,0,12,0,-12
12046,0,0,69,0,-69
12047,1,0,26,0,-26
12048,1,0,80,0,-80
12049,1,1,431,1756,1325
12050,1,0,161,0,-161
12051,0,0,1,0,-1
12052,0,0,14,0,-14
12053,1,0,28,0,-28
12054,1,0,52,0,-52
12055,1,0,67,0,-67
12056,0,0,91,0,-91
12057,0,0,22,0,-22
12058,1,0,126,0,-126
12059,1,1,672,1643,971
12060,1,1,35,1519,1484
12061,1,0,135,0,-135
12062,1,0,65,0,-65
12063,1,1,1109,1200,91
12064,1,0,11,0,-11
12065,1,1,373,2385,2012
12066,1,1,424,1377,953
12067,0,0,58,0,-58
12068,0,0,166,0,-166
12069,1,0,12,0,-12
12070,1,1,519,1947,1428
12071,0,0,29,0,-29
12072,1,1,412,1914,1502
12073,1,0,32,0,-32
12074,0,0,14,0,-14
12075,0,0,14,0,-14
12076,1,1,261,1875,1614
12077,1,1,302,1209,907
12078,1,0,17,0,-17
12079,1,0,17,0,-17
12080,0,0,16,0,-16
12081,1,0,82,0,-82
12082,1,0,98,0,-98
12083,0,0,22,0,-22
12084,0,0,143,0,-143
12085,1,1,413,1251,838
12086,0,0,55,0,-55
12087,1,0,100,0,-100
12088,1,0,55,0,-55
12089,0,0,8,0,-8
12090,1,1,492,1319,827
12091,1,0,32,0,-32
12092,0,0,50,0,-50
12093,1,1,1293,1425,132
12094,0,0,13,0,-13
12095,0,0,19,0,-19
12096,0,0,36,0,-36
12097,1,1,266,1204,938
12098,1,0,5,0,-5
12099,0,0,0,0,0
12100,1,1,276,1933,1657
12101,1,1,95,1625,1530
12102,1,1,824,1716,892
12103,0,0,29,0,-29
12104,0,0,21,0,-21
12105,1,1,1159,1484,325
12106,0,0,34,0,-34
12107,0,0,210,0,-210
12108,0,0,178,0,-178
12109,1,1,348,2550,2202
12110,0,0,147,0,-147
12111,1,0,18,0,-18
12112,1,0,56,0,-56
12113,1,0,142,0,-142
12114,1,1,845,1287,442
12115,0,0,30,0,-30
12116,1,1,576,1232,656
12117,1,0,166,0,-166
12118,1,1,386,1546,1160
12119,1,0,97,0,-97
12120,0,0,41,0,-41
12121,1,1,106,1776,1670
12122,1,1,557,1865,1308
12123,0,0,22,0,-22
12124,1,0,3,0,-3
12125,1,0,57,0,-57
12126,0,0,26,0,-26
12127,0,0,38,0,-38
12128,0,0,21,0,-21
12129,1,0,26,0,-26
12130,1,1,278,1203,925
12131,1,1,346,1244,898
12132,0,0,100,0,-100
12133,1,1,1095,1767,672
12134,1,1,215,1242,1027
12135,1,1,128,1811,1683
12136,1,0,22,0,-22
12137,1,1,171,1649,1478
12138,1,1,25,1523,1498
12139,1,0,93,0,-93
12140,1,1,2519,1319,-1200
12141,1,1,2640,1350,-1290
12142,1,1,421,2601,2180
12143,0,0,106,0,-106
12144,1,1,152,1347,1195
12145,0,0,53,0,-53
12146,0,0,28,0,-28
12147,0,0,31,0,-31
12148,1,0,30,0,-30
12149,0,0,142,0,-142
12150,1,0,116,0,-116
12151,1,0,43,0,-43
12152,1,1,78,1546,1468
12153,0,0,120,0,-120
12154,1,1,608,1308,700
12155,1,1,126,1341,1215
12156,0,0,5,0,-5
12157,1,0,53,0,-53
12158,1,1,153,1337,1184
12159,0,0,19,0,-19
12160,0,0,74,0,-74
12161,1,1,423,1580,1157
12162,1,1,608,1421,813
12163,1,0,51,0,-51
12164,0,0,46,0,-46
12165,0,0,39,0,-39
12166,0,0,80,0,-80
12167,1,1,1346,1572,226
12168,1,1,837,1208,371
12169,1,0,1,0,-1
12170,0,0,22,0,-22
12171,1,1,193,1316,1123
12172,1,0,2,0,-2
12173,1,0,9,0,-9
12174,0,0,0,0,0
12175,1,0,47,0,-47
12176,1,0,10,0,-10
12177,0,0,66,0,-66
12178,1,0,12,0,-12
12179,1,0,44,0,-44
12180,0,0,114,0,-114
12181,1,0,59,0,-59
12182,1,1,87,1798,1711
12183,0,0,4,0,-4
12184,0,0,32,0,-32
12185,1,1,189,1642,1453
12186,1,1,229,1889,1660
12187,1,1,457,1733,1276
12188,1,0,48,0,-48
12189,0,0,36,0,-36
12190,0,0,8,0,-8
12191,1,1,333,3914,3581
12192,0,0,31,0,-31
12193,1,0,51,0,-51
12194,0,0,5,0,-5
12195,1,1,642,1286,644
12196,0,0,13,0,-13
12197,1,1,1798,1313,-485
12198,1,1,1010,1393,383
12199,0,0,15,0,-15
12200,1,0,84,0,-84
12201,1,0,8,0,-8
12202,0,0,18,0,-18
12203,1,1,1102,1569,467
12204,1,0,32,0,-32
12205,1,0,106,0,-106
12206,0,0,12,0,-12
12207,1,0,113,0,-113
12208,0,0,47,0,-47
12209,0,0,4,0,-4
12210,0,0,137,0,-137
12211,1,1,1132,1542,410
12212,1,1,55,1350,1295
12213,1,0,27,0,-27
12214,1,0,17,0,-17
12215,0,0,4,0,-4
12216,0,0,107,0,-107
12217,1,0,30,0,-30
12218,1,1,1208,2319,1111
12219,1,1,911,1308,397
12220,0,0,108,0,-108
12221,1,1,118,1407,1289
12222,1,0,24,0,-24
12223,1,1,564,1715,1151
12224,1,0,29,0,-29
12225,1,1,307,2146,1839
12226,0,0,8,0,-8
12227,1,1,1126,1917,791
12228,1,1,39,5540,5501
12229,1,1,1687,1481,-206
12230,1,0,48,0,-48
12231,1,1,1307,2414,1107
12232,1,0,3,0,-3
12233,0,0,34,0,-34
12234,1,1,611,1590,979
12235,0,0,3,0,-3
12236,1,1,521,1406,885
12237,1,0,170,0,-170
12238,1,1,740,1498,758
12239,1,1,392,1772,1380
12240,0,0,65,0,-65
12241,1,1,1575,1390,-185
12242,1,0,80,0,-80
12243,1,1,724,1203,479
12244,1,1,122,1286,1164
12245,1,0,35,0,-35
12246,0,0,13,0,-13
12247,1,1,30,1230,1200
12248,1,1,1958,1317,-641
12249,1,1,216,2117,1901
12250,1,1,582,1249,667
12251,0,0,22,0,-22
12252,0,0,178,0,-178
12253,1,1,407,1938,1531
12254,1,0,91,0,-91
12255,1,0,2,0,-2
12256,1,1,202,1435,1233
12257,0,0,82,0,-82
12258,1,1,244,1963,1719
12259,1,0,26,0,-26
12260,0,0,105,0,-105
12261,1,0,131,0,-131
12262,1,1,1034,1571,537
12263,0,0,31,0,-31
12264,1,0,106,0,-106
12265,1,0,65,0,-65
12266,0,0,84,0,-84
12267,1,0,11,0,-11
12268,0,0,28,0,-28
12269,0,0,89,0,-89
12270,0,0,139,0,-139
12271,0,0,33,0,-33
12272,0,0,137,0,-137
12273,0,0,59,0,-59
12274,1,1,58,1337,1279
12275,1,1,177,1535,1358
12276,1,0,57,0,-57
12277,1,1,230,1288,1058
12278,1,0,102,0,-102
12279,0,0,125,0,-125
12280,1,1,555,1980,1425
12281,1,0,48,0,-48
12282,0,0,1,0,-1
12283,1,0,141,0,-141
12284,1,1,127,1234,1107
12285,0,0,24,0,-24
12286,0,0,71,0,-71
12287,1,1,482,1252,770
12288,0,0,0,0,0
12289,1,0,92,0,-92
12290,0,0,48,0,-48
12291,1,0,10,0,-10
12292,1,0,4,0,-4
12293,0,0,15,0,-15
12294,1,0,92,0,-92
12295,0,0,49,0,-49
12296,1,1,804,1244,440
12297,0,0,132,0,-132
12298,1,1,431,1227,796
12299,0,0,276,0,-276
12300,1,0,59,0,-59
12301,1,1,287,1615,1328
12302,0,0,103,0,-103
12303,0,0,129,0,-129
12304,1,0,16,0,-16
12305,0,0,87,0,-87
12306,1,0,87,0,-87
12307,0,0,21,0,-21
12308,0,0,21,0,-21
12309,1,1,456,1676,1220
12310,1,0,30,0,-30
12311,0,0,3,0,-3
12312,1,1,305,1278,973
12313,0,0,76,0,-76
12314,0,0,47,0,-47
12315,0,0,59,0,-59
12316,1,0,250,0,-250
12317,0,0,121,0,-121
12318,0,0,311,0,-311
12319,0,0,69,0,-69
12320,1,1,137,1269,1132
12321,1,1,255,1242,987
12322,1,1,147,1536,1389
12323,1,0,102,0,-102
12324,1,1,237,1576,1339
12325,1,0,31,0,-31
12326,1,1,130,1894,1764
12327,1,0,24,0,-24
12328,1,0,120,0,-120
12329,1,1,452,1252,800
12330,1,1,67,2024,1957
12331,1,0,5,0,-5
12332,0,0,19,0,-19
12333,1,1,159,1318,1159
12334,1,1,164,1399,1235
12335,0,0,64,0,-64
12336,0,0,5,0,-5
12337,0,0,40,0,-40
12338,0,0,139,0,-139
12339,1,0,7,0,-7
12340,1,0,169,0,-169
12341,0,0,12,0,-12
12342,0,0,19,0,-19
12343,0,0,75,0,-75
12344,1,0,41,0,-41
12345,0,0,133,0,-133
12346,1,1,576,1257,681
12347,1,1,697,1425,728
12348,0,0,210,0,-210
12349,1,1,260,1334,1074
12350,1,1,491,1223,732
12351,1,0,102,0,-102
12352,1,1,122,1290,1168
12353,0,0,111,0,-111
12354,1,1,113,1305,1192
12355,1,0,12,0,-12
12356,1,0,69,0,-69
12357,0,0,4,0,-4
12358,1,0,2,0,-2
12359,1,1,133,1426,1293
12360,1,1,2397,1993,-404
12361,1,1,238,1322,1084
12362,0,0,250,0,-250
12363,1,1,665,1288,623
12364,0,0,39,0,-39
12365,0,0,40,0,-40
12366,0,0,22,0,-22
12367,0,0,41,0,-41
12368,0,0,12,0,-12
12369,1,0,76,0,-76
12370,1,1,460,1524,1064
12371,1,1,613,1269,656
12372,1,0,118,0,-118
12373,0,0,85,0,-85
12374,1,1,1382,1600,218
12375,0,0,70,0,-70
12376,0,0,55,0,-55
12377,1,1,688,1218,530
12378,0,0,9,0,-9
12379,0,0,29,0,-29
12380,0,0,73,0,-73
12381,0,0,35,0,-35
12382,1,1,403,1270,867
12383,0,0,69,0,-69
12384,1,1,1011,1446,435
12385,0,0,125,0,-125
12386,0,0,64,0,-64
12387,0,0,30,0,-30
12388,1,0,42,0,-42
12389,1,0,2,0,-2
12390,0,0,196,0,-196
12391,1,0,3,0,-3
12392,1,0,54,0,-54
12393,1,0,133,0,-133
12394,0,0,75,0,-75
12395,1,0,3,0,-3
12396,1,0,173,0,-173
12397,0,0,32,0,-32
12398,1,1,98,1441,1343
12399,1,0,7,0,-7
12400,0,0,40,0,-40
12401,1,1,56,1428,1372
12402,1,1,160,1250,1090
12403,1,1,920,1294,374
12404,0,0,94,0,-94
12405,1,0,50,0,-50
12406,1,0,61,0,-61
12407,1,1,566,2156,1590
12408,0,0,13,0,-13
12409,1,0,22,0,-22
12410,0,0,14,0,-14
12411,1,1,367,3089,2722
12412,0,0,8,0,-8
12413,0,0,49,0,-49
12414,1,0,223,0,-223
12415,0,0,2,0,-2
12416,0,0,21,0,-21
12417,1,1,467,2237,1770
12418,1,0,19,0,-19
12419,1,0,17,0,-17
12420,1,1,1395,1472,77
12421,1,0,23,0,-23
12422,0,0,5,0,-5
12423,1,1,104,1935,1831
12424,1,1,212,1500,1288
12425,0,0,0,0,0
12426,0,0,29,0,-29
12427,1,0,65,0,-65
12428,0,0,8,0,-8
12429,0,0,29,0,-29
12430,1,0,33,0,-33
12431,0,0,135,0,-135
12432,1,0,10,0,-10
12433,0,0,38,0,-38
12434,1,0,15,0,-15
12435,0,0,17,0,-17
12436,1,1,864,1527,663
12437,1,0,57,0,-57
12438,0,0,30,0,-30
12439,0,0,16,0,-16
12440,1,0,0,0,0
12441,1,1,30,1638,1608
12442,1,1,352,1383,1031
12443,1,0,22,0,-22
12444,1,1,451,1608,1157
12445,0,0,45,0,-45
12446,1,1,1229,1211,-18
12447,0,0,91,0,-91
12448,0,0,16,0,-16
12449,0,0,93,0,-93
12450,1,1,533,1945,1412
12451,0,0,73,0,-73
12452,1,1,454,2439,1985
12453,0,0,40,0,-40
12454,1,1,6,1724,1718
12455,0,0,5,0,-5
12456,0,0,0,0,0
12457,1,0,10,0,-10
12458,0,0,12,0,-12
12459,0,0,1,0,-1
12460,1,1,1402,1252,-150
12461,1,1,1179,1331,152
12462,0,0,28,0,-28
12463,1,1,1968,1377,-591
12464,1,1,361,2506,2145
12465,0,0,34,0,-34
12466,0,0,82,0,-82
12467,1,0,44,0,-44
12468,0,0,11,0,-11
12469,1,1,789,1370,581
12470,0,0,5,0,-5
12471,0,0,16,0,-16
12472,0,0,286,0,-286
12473,1,0,94,0,-94
12474,1,1,1625,3262,1637
12475,0,0,34,0,-34
12476,1,1,83,1262,1179
12477,1,0,22,0,-22
12478,0,0,26,0,-26
12479,0,0,106,0,-106
12480,1,0,51,0,-51
12481,1,1,322,1440,1118
12482,0,0,6,0,-6
12483,1,1,325,1412,1087
12484,1,1,691,1331,640
12485,0,0,19,0,-19
12486,0,0,263,0,-263
12487,1,1,1013,1913,900
12488,1,1,574,1301,727
12489,1,1,120,1735,1615
12490,1,0,66,0,-66
12491,1,1,415,1257,842
12492,1,1,256,1315,1059
12493,1,1,765,1252,487
12494,1,1,614,1420,806
12495,1,0,1,0,-1
12496,1,1,113,1458,1345
12497,1,0,1,0,-1
12498,1,0,26,0,-26
12499,1,0,41,0,-41
12500,0,0,162,0,-162
12501,1,1,1197,1341,144
12502,1,0,19,0,-19
12503,1,0,73,0,-73
12504,1,1,253,2319,2066
12505,1,0,133,0,-133
12506,1,1,352,1207,855
12507,1,1,290,1223,933
12508,1,1,189,3837,3648
12509,1,1,148,1323,1175
12510,1,0,127,0,-127
12511,0,0,85,0,-85
12512,0,0,23,0,-23
12513,1,0,32,0,-32
12514,0,0,0,0,0
12515,1,1,2606,1416,-1190
12516,0,0,33,0,-33
12517,0,0,123,0,-123
12518,1,0,13,0,-13
12519,1,1,641,1201,560
12520,1,1,133,1316,1183
12521,1,0,8,0,-8
12522,0,0,52,0,-52
12523,1,1,75,1516,1441
12524,1,0,22,0,-22
12525,1,0,7,0,-7
12526,0,0,36,0,-36
12527,1,1,178,4677,4499
12528,1,1,2108,1765,-343
12529,0,0,31,0,-31
12530,1,1,98,1290,1192
12531,0,0,4,0,-4
12532,1,0,8,0,-8
12533,1,1,117,1411,1294
12534,1,1,118,2355,2237
12535,0,0,21,0,-21
12536,1,0,43,0,-43
12537,0,0,70,0,-70
12538,1,0,26,0,-26
12539,1,1,350,1352,1002
12540,0,0,2,0,-2
12541,0,0,94,0,-94
12542,1,1,355,2191,1836
12543,1,0,102,0,-102
12544,0,0,12,0,-12
12545,0,0,20,0,-20
12546,0,0,78,0,-78
12547,1,0,4,0,-4
12548,1,1,540,1227,687
12549,1,0,117,0,-117
12550,0,0,154,0,-154
12551,0,0,14,0,-14
12552,1,1,1047,1926,879
12553,1,1,472,1607,1135
12554,1,1,765,1744,979
12555,1,1,1961,1521,-440
12556,1,0,59,0,-59
12557,1,1,1716,1214,-502
12558,1,1,2312,1524,-788
12559,1,1,1908,1571,-337
12560,1,0,44,0,-44
12561,1,1,136,1736,1600
12562,0,0,34,0,-34
12563,0,0,15,0,-15
12564,0,0,46,0,-46
12565,0,0,302,0,-302
12566,1,0,23,0,-23
12567,0,0,1,0,-1
12568,0,0,49,0,-49
12569,0,0,34,0,-34
12570,1,0,31,0,-31
12571,0,0,4,0,-4
12572,1,0,84,0,-84
12573,1,1,145,1545,1400
12574,1,1,297,1248,951
12575,1,0,45,0,-45
12576,0,0,23,0,-23
12577,1,0,7,0,-7
12578,1,0,60,0,-60
12579,0,0,119,0,-119
12580,0,0,154,0,-154
12581,0,0,66,0,-66
12582,1,1,193,1234,1041
12583,1,1,97,1863,1766
12584,1,0,111,0,-111
12585,1,0,13,0,-13
12586,1,1,424,3383,2959
12587,1,1,658,2032,1374
12588,1,0,73,0,-73
12589,1,0,67,0,-67
12590,0,0,15,0,-15
12591,0,0,3,0,-3
12592,1,0,39,0,-39
12593,1,0,2,0,-2
12594,0,0,5,0,-5
12595,1,0,12,0,-12
12596,0,0,10,0,-10
12597,0,0,39,0,-39
12598,0,0,150,0,-150
12599,0,0,111,0,-111
12600,1,0,21,0,-21
12601,1,0,2,0,-2
12602,0,0,136,0,-136
12603,1,0,3,0,-3
12604,0,0,13,0,-13
12605,1,1,804,1760,956
12606,1,0,95,0,-95
12607,1,1,1472,2629,1157
12608,1,0,23,0,-23
12609,0,0,8,0,-8
12610,0,0,18,0,-18
12611,1,1,59,1666,1607
12612,0,0,55,0,-55
12613,0,0,120,0,-120
12614,0,0,1,0,-1
12615,0,0,39,0,-39
12616,1,0,25,0,-25
12617,1,1,549,1349,800
12618,1,1,208,1303,1095
12619,1,0,104,0,-104
12620,1,0,67,0,-67
12621,0,0,34,0,-34
12622,1,1,600,1531,931
12623,0,0,19,0,-19
12624,1,0,57,0,-57
12625,1,0,9,0,-9
12626,1,0,32,0,-32
12627,1,1,1874,1259,-615
12628,1,1,239,2515,2276
12629,1,1,1726,1206,-520
12630,0,0,37,0,-37
12631,0,0,13,0,-13
12632,1,1,15,2298,2283
12633,0,0,19,0,-19
12634,1,1,653,1466,813
12635,0,0,7,0,-7
12636,0,0,26,0,-26
12637,0,0,49,0,-49
12638,1,0,72,0,-72
12639,0,0,13,0,-13
12640,1,1,654,1243,589
12641,1,0,221,0,-221
12642,0,0,11,0,-11
12643,0,0,3,0,-3
12644,1,0,28,0,-28
12645,0,0,8,0,-8
12646,0,0,16,0,-16
12647,0,0,175,0,-175
12648,1,1,550,1277,727
12649,1,0,83,0,-83
12650,0,0,14,0,-14
12651,0,0,27,0,-27
12652,0,0,85,0,-85
12653,0,0,75,0,-75
12654,1,0,31,0,-31
12655,0,0,17,0,-17
12656,1,1,1648,3639,1991
12657,1,1,905,1667,762
12658,0,0,24,0,-24
12659,1,1,1003,1581,578
12660,0,0,20,0,-20
12661,0,0,56,0,-56
12662,1,0,4,0,-4
12663,0,0,2,0,-2
12664,0,0,37,0,-37
12665,1,0,23,0,-23
12666,1,0,10,0,-10
12667,1,0,33,0,-33
12668,1,0,67,0,-67
12669,1,0,7,0,-7
12670,1,0,187,0,-187
12671,1,0,19,0,-19
12672,1,0,11,0,-11
12673,0,0,78,0,-78
12674,0,0,173,0,-173
12675,1,1,584,1516,932
12676,1,1,1856,1396,-460
12677,1,1,100,1316,1216
12678,0,0,0,0,0
12679,0,0,39,0,-39
12680,1,1,68,1447,1379
12681,0,0,66,0,-66
12682,0,0,13,0,-13
12683,1,0,51,0,-51
12684,1,1,202,1346,1144
12685,0,0,57,0,-57
12686,1,1,134,1209,1075
12687,1,0,261,0,-261
12688,1,0,50,0,-50
12689,1,0,7,0,-7
12690,1,1,393,1422,1029
12691,1,1,808,1352,544
12692,1,1,289,1514,1225
12693,1,0,65,0,-65
12694,1,0,19,0,-19
12695,1,1,180,1229,1049
12696,1,0,5,0,-5
12697,1,1,206,1200,994
12698,1,1,1051,1289,238
12699,0,0,15,0,-15
12700,0,0,23,0,-23
12701,1,1,172,1763,1591
12702,1,1,388,1305,917
12703,1,0,8,0,-8
12704,0,0,58,0,-58
12705,0,0,38,0,-38
12706,0,0,49,0,-49
12707,1,1,379,1395,1016
12708,1,0,0,0,0
12709,0,0,3,0,-3
12710,1,0,2,0,-2
12711,0,0,40,0,-40
12712,0,0,19,0,-19
12713,1,1,118,2961,2843
12714,1,0,58,0,-58
12715,0,0,19,0,-19
12716,1,0,9,0,-9
12717,0,0,36,0,-36
12718,0,0,6,0,-6
12719,0,0,169,0,-169
12720,0,0,85,0,-85
12721,1,0,0,0,0
12722,1,0,28,0,-28
12723,1,0,59,0,-59
12724,1,1,202,2777,2575
12725,1,0,11,0,-11
12726,1,1,101,1902,1801
12727,1,0,53,0,-53
12728,0,0,212,0,-212
12729,1,1,282,1265,983
12730,1,1,147,1348,1201
12731,1,1,837,1644,807
12732,1,0,6,0,-6
12733,1,0,6,0,-6
12734,0,0,8,0,-8
12735,1,0,56,0,-56
12736,0,0,36,0,-36
12737,1,0,4,0,-4
12738,0,0,83,0,-83
12739,1,1,515,1392,877
12740,0,0,5,0,-5
12741,0,0,205,0,-205
12742,0,0,63,0,-63
12743,1,1,273,1432,1159
12744,0,0,8,0,-8
12745,0,0,74,0,-74
12746,0,0,140,0,-140
12747,0,0,7,0,-7
12748,1,0,3,0,-3
12749,1,0,16,0,-16
12750,1,0,7,0,-7
12751,1,1,2091,1205,-886
12752,0,0,20,0,-20
12753,1,1,127,1258,1131
12754,1,0,6,0,-6
12755,1,1,226,4401,4175
12756,0,0,3,0,-3
12757,0,0,52,0,-52
12758,0,0,13,0,-13
12759,0,0,17,0,-17
12760,0,0,29,0,-29
12761,1,0,36,0,-36
12762,1,1,311,1501,1190
12763,1,0,43,0,-43
12764,1,1,480,1459,979
12765,1,1,612,1922,1310
12766,0,0,8,0,-8
12767,1,0,24,0,-24
12768,0,0,13,0,-13
12769,1,0,10,0,-10
12770,0,0,14,0,-14
12771,1,1,346,1765,1419
12772,1,1,558,1233,675
12773,1,0,167,0,-167
12774,0,0,234,0,-234
12775,0,0,13,0,-13
12776,0,0,8,0,-8
12777,0,0,33,0,-33
12778,1,0,24,0,-24
12779,1,0,100,0,-100
12780,1,1,105,1421,1316
12781,0,0,2,0,-2
12782,0,0,49,0,-49
12783,0,0,30,0,-30
12784,1,0,10,0,-10
12785,0,0,9,0,-9
12786,1,0,6,0,-6
12787,0,0,23,0,-23
12788,0,0,56,0,-56
12789,0,0,3,0,-3
12790,1,0,38,0,-38
12791,1,1,545,1743,1198
12792,1,1,2504,1917,-587
12793,0,0,74,0,-74
12794,0,0,23,0,-23
12795,0,0,0,0,0
12796,1,0,77,0,-77
12797,1,0,89,0,-89
12798,1,1,431,1366,935
12799,1,1,440,1580,1140
12800,1,1,209,1302,1093
12801,0,0,46,0,-46
12802,1,0,20,0,-20
12803,1,1,534,6588,6054
12804,0,0,0,0,0
12805,1,1,965,1320,355
12806,0,0,25,0,-25
12807,1,1,222,1309,1087
12808,1,1,1435,1375,-60
12809,1,0,5,0,-5
12810,0,0,7,0,-7
12811,0,0,97,0,-97
12812,1,0,25,0,-25
12813,0,0,103,0,-103
12814,1,1,444,2148,1704
12815,1,1,225,1947,1722
12816,0,0,0,0,0
12817,0,0,31,0,-31
12818,0,0,12,0,-12
12819,0,0,103,0,-103
12820,1,0,67,0,-67
12821,1,0,111,0,-111
12822,1,0,131,0,-131
12823,0,0,7,0,-7
12824,1,1,328,1204,876
12825,1,0,6,0,-6
12826,1,1,252,1295,1043
12827,0,0,13,0,-13
12828,0,0,8,0,-8
12829,1,1,43,1732,1689
12830,1,0,46,0,-46
12831,0,0,95,0,-95
12832,0,0,97,0,-97
12833,1,0,140,0,-140
12834,1,1,351,1473,1122
12835,0,0,13,0,-13
12836,1,0,5,0,-5
12837,1,1,489,1504,1015
12838,1,1,1082,1280,198
12839,1,1,290,1482,1192
12840,1,1,1453,1361,-92
12841,1,1,625,1308,683
12842,1,0,47,0,-47
12843,1,1,222,1387,1165
12844,1,0,73,0,-73
12845,0,0,74,0,-74
12846,0,0,33,0,-33
12847,1,0,84,0,-84
12848,0,0,97,0,-97
12849,0,0,7,0,-7
12850,1,0,48,0,-48
12851,1,0,9,0,-9
12852,0,0,15,0,-15
12853,0,0,43,0,-43
12854,1,1,270,1240,970
12855,0,0,46,0,-46
12856,0,0,60,0,-60
12857,1,0,136,0,-136
12858,1,1,785,1334,549
12859,1,1,1074,1912,838
12860,1,0,17,0,-17
12861,0,0,34,0,-34
12862,1,1,71,2113,2042
12863,0,0,50,0,-50
12864,0,0,91,0,-91
12865,0,0,124,0,-124
12866,0,0,25,0,-25
12867,0,0,10,0,-10
12868,1,0,247,0,-247
12869,1,0,22,0,-22
12870,0,0,37,0,-37
12871,0,0,11,0,-11
12872,1,1,276,1273,997
12873,1,1,268,1210,942
12874,1,0,276,0,-276
12875,1,1,1092,1849,757
12876,0,0,58,0,-58
12877,0,0,1,0,-1
12878,1,1,540,2067,1527
12879,1,1,1959,1244,-715
12880,1,0,37,0,-37
12881,1,0,2,0,-2
12882,1,0,33,0,-33
12883,1,1,190,1649,1459
12884,1,0,30,0,-30
12885,1,1,450,1330,880
12886,1,1,264,1312,1048
12887,1,1,158,3852,3694
12888,1,1,1110,1388,278
12889,1,0,16,0,-16
12890,1,1,360,2894,2534
12891,1,1,602,1260,658
12892,0,0,6,0,-6
12893,0,0,22,0,-22
12894,0,0,79,0,-79
12895,1,0,3,0,-3
12896,0,0,18,0,-18
12897,0,0,2,0,-2
12898,0,0,1,0,-1
12899,0,0,66,0,-66
12900,1,1,548,1287,739
12901,1,1,616,1246,630
12902,1,0,19,0,-19
12903,0,0,11,0,-11
12904,1,1,260,1606,1346
12905,1,1,77,1582,1505
12906,1,1,721,1218,497
12907,1,1,449,1418,969
12908,1,0,1,0,-1
12909,1,1,211,1492,1281
12910,1,0,24,0,-24
12911,0,0,56,0,-56
12912,1,0,23,0,-23
12913,1,1,1396,1809,413
12914,0,0,72,0,-72
12915,1,1,351,1350,999
12916,1,0,117,0,-117
12917,0,0,126,0,-126
12918,1,0,168,0,-168
12919,1,1,384,1520,1136
12920,1,0,53,0,-53
12921,0,0,19,0,-19
12922,0,0,27,0,-27
12923,0,0,135,0,-135
12924,1,1,73,1214,1141
12925,1,1,529,1294,765
12926,1,1,700,2200,1500
12927,1,0,3,0,-3
12928,0,0,40,0,-40
12929,1,0,47,0,-47
12930,0,0,38,0,-38
12931,1,1,1036,1412,376
12932,0,0,28,0,-28
12933,1,0,14,0,-14
12934,0,0,0,0,0
12935,0,0,2,0,-2
12936,0,0,94,0,-94
12937,1,0,7,0,-7
12938,1,0,9,0,-9
12939,1,0,44,0,-44
12940,0,0,25,0,-25
12941,1,0,28,0,-28
12942,1,1,448,1336,888
12943,1,0,48,0,-48
12944,0,0,3,0,-3
12945,0,0,25,0,-25
12946,0,0,27,0,-27
12947,0,0,5,0,-5
12948,0,0,59,0,-59
12949,1,0,21,0,-21
12950,1,0,7,0,-7
12951,1,0,28,0,-28
12952,0,0,18,0,-18
12953,1,1,74,1857,1783
12954,1,0,55,0,-55
12955,1,1,554,1896,1342
12956,1,1,1970,1252,-718
12957,1,1,501,2906,2405
12958,0,0,37,0,-37
12959,1,1,360,1229,869
12960,1,1,512,1516,1004
12961,1,0,9,0,-9
12962,1,0,63,0,-63
12963,1,1,908,1408,500
12964,1,0,3,0,-3
12965,1,1,273,1256,983
12966,0,0,26,0,-26
12967,0,0,23,0,-23
12968,1,1,532,1919,1387
12969,1,0,148,0,-148
12970,0,0,1,0,-1
12971,0,0,14,0,-14
12972,1,0,95,0,-95
12973,1,1,737,1233,496
12974,1,1,144,1588,1444
12975,1,1,158,1711,1553
12976,1,0,109,0,-109
12977,1,0,14,0,-14
12978,1,1,557,1300,743
12979,1,0,25,0,-25
12980,1,1,88,1389,1301
12981,1,1,355,1259,904
12982,0,0,57,0,-57
12983,0,0,142,0,-142
12984,0,0,32,0,-32
12985,0,0,14,0,-14
12986,0,0,0,0,0
12987,0,0,63,0,-63
12988,0,0,12,0,-12
12989,0,0,192,0,-192
12990,1,1,1073,1275,202
12991,1,1,243,2955,2712
12992,1,0,27,0,-27
12993,0,0,30,0,-30
12994,0,0,79,0,-79
12995,1,0,80,0,-80
12996,0,0,140,0,-140
12997,1,1,158,1415,1257
12998,1,1,594,1284,690
12999,1,0,82,0,-82
13000,1,0,42,0,-42
13001,1,1,324,1275,951
13002,1,1,39,1763,1724
13003,1,1,139,1688,1549
13004,0,0,14,0,-14
13005,0,0,0,0,0
13006,1,0,17,0,-17
13007,0,0,40,0,-40
13008,1,1,309,1363,1054
13009,1,0,4,0,-4
13010,1,1,952,1210,258
13011,1,1,500,1372,872
13012,1,1,299,1600,1301
13013,0,0,104,0,-104
13014,1,0,11,0,-11
13015,1,1,230,1273,1043
13016,1,1,163,1290,1127
13017,1,1,471,1210,739
13018,1,0,67,0,-67
13019,0,0,173,0,-173
13020,0,0,65,0,-65
13021,0,0,18,0,-18
13022,0,0,60,0,-60
13023,0,0,31,0,-31
13024,0,0,122,0,-122
13025,1,0,134,0,-134
13026,1,1,386,1317,931
13027,0,0,71,0,-71
13028,1,1,494,1450,956
13029,1,0,84,0,-84
13030,1,0,20,0,-20
13031,0,0,86,0,-86
13032,1,1,49,1324,1275
13033,1,1,170,1221,1051
13034,0,0,7,0,-7
13035,0,0,64,0,-64
13036,0,0,9,0,-9
13037,1,1,476,2326,1850
13038,1,0,7,0,-7
13039,1,1,430,1384,954
13040,0,0,61,0,-61
13041,1,0,15,0,-15
13042,0,0,9,0,-9
13043,1,1,303,1464,1161
13044,0,0,18,0,-18
13045,0,0,72,0,-72
13046,1,0,77,0,-77
13047,0,0,13,0,-13
13048,0,0,173,0,-173
13049,1,1,957,1384,427
13050,1,1,731,1296,565
13051,1,0,17,0,-17
13052,0,0,30,0,-30
13053,1,0,0,0,0
13054,1,0,67,0,-67
13055,0,0,25,0,-25
13056,1,1,400,1359,959
13057,0,0,49,0,-49
13058,1,1,96,1310,1214
13059,1,0,97,0,-97
13060,1,0,124,0,-124
13061,1,1,493,1447,954
13062,0,0,90,0,-90
13063,1,1,436,1597,1161
13064,0,0,22,0,-22
13065,0,0,6,0,-6
13066,0,0,25,0,-25
13067,1,0,34,0,-34
13068,0,0,3,0,-3
13069,1,1,743,1793,1050
13070,1,0,15,0,-15
13071,0,0,54,0,-54
13072,0,0,7,0,-7
13073,1,0,67,0,-67
13074,1,1,207,1416,1209
13075,1,0,42,0,-42
13076,0,0,66,0,-66
13077,1,1,1174,2224,1050
13078,0,0,0,0,0
13079,1,0,17,0,-17
13080,0,0,84,0,-84
13081,0,0,18,0,-18
13082,1,1,88,1233,1145
13083,0,0,28,0,-28
13084,0,0,23,0,-23
13085,1,1,170,2106,1936
13086,0,0,29,0,-29
13087,0,0,8,0,-8
13088,1,1,819,3145,2326
13089,1,0,35,0,-35
13090,1,1,297,1450,1153
13091,0,0,182,0,-182
13092,0,0,4,0,-4
13093,1,1,1831,1262,-569
13094,1,0,12,0,-12
13095,1,0,15,0,-15
13096,1,1,1304,1362,58
13097,1,0,19,0,-19
13098,0,0,41,0,-41
13099,1,1,760,1424,664
13100,1,1,12,1634,1622
13101,0,0,58,0,-58
13102,1,1,579,4325,3746
13103,1,1,223,1279,1056
13104,1,1,176,1393,1217
13105,1,0,66,0,-66
13106,1,1,730,1279,549
13107,1,1,709,1724,1015
13108,1,1,1102,1333,231
13109,1,0,14,0,-14
13110,1,0,53,0,-53
13111,0,0,3,0,-3
13112,0,0,66,0,-66
13113,1,0,24,0,-24
13114,0,0,121,0,-121
13115,1,0,92,0,-92
13116,1,1,211,2264,2053
13117,1,1,477,1742,1265
13118,1,0,20,0,-20
13119,0,0,80,0,-80
13120,0,0,96,0,-96
13121,1,0,35,0,-35
13122,1,0,66,0,-66
13123,1,1,1748,2153,405
13124,1,1,419,1347,928
13125,0,0,86,0,-86
13126,1,1,855,1921,1066
13127,1,0,25,0,-25
13128,1,1,552,1705,1153
13129,0,0,58,0,-58
13130,1,0,65,0,-65
13131,1,0,48,0,-48
13132,0,0,247,0,-247
13133,0,0,55,0,-55
13134,0,0,33,0,-33
13135,1,1,734,3171,2437
13136,1,0,53,0,-53
13137,1,0,7,0,-7
13138,0,0,61,0,-61
13139,1,1,1299,1275,-24
13140,1,1,246,1316,1070
13141,1,0,2,0,-2
13142,0,0,43,0,-43
13143,1,1,892,1406,514
13144,1,0,61,0,-61
13145,1,1,591,1796,1205
13146,0,0,12,0,-12
13147,0,0,19,0,-19
13148,0,0,3,0,-3
13149,1,1,306,1335,1029
13150,0,0,25,0,-25
13151,1,1,182,2411,2229
13152,0,0,15,0,-15
13153,1,0,14,0,-14
13154,1,0,23,0,-23
13155,0,0,174,0,-174
13156,0,0,5,0,-5
13157,0,0,23,0,-23
13158,0,0,77,0,-77
13159,0,0,35,0,-35
13160,1,0,30,0,-30
13161,0,0,16,0,-16
13162,1,1,250,1317,1067
13163,0,0,48,0,-48
13164,1,1,631,2562,1931
13165,1,0,20,0,-20
13166,0,0,69,0,-69
13167,1,0,1,0,-1
13168,1,1,126,1649,1523
13169,1,0,102,0,-102
13170,0,0,19,0,-19
13171,1,0,5,0,-5
13172,1,0,143,0,-143
13173,1,1,488,1435,947
13174,1,1,241,1483,1242
13175,1,1,342,1458,1116
13176,1,1,188,1216,1028
13177,0,0,18,0,-18
13178,1,0,9,0,-9
13179,1,0,19,0,-19
13180,0,0,159,0,-159
13181,1,1,810,1317,507
13182,0,0,42,0,-42
13183,1,1,683,1874,1191
13184,1,1,1429,1201,-228
13185,1,1,102,1427,1325
13186,0,0,149,0,-149
13187,1,0,63,0,-63
13188,1,0,19,0,-19
13189,1,1,308,1812,1504
13190,0,0,70,0,-70
13191,0,0,1,0,-1
13192,0,0,14,0,-14
13193,1,0,12,0,-12
13194,1,0,160,0,-160
13195,0,0,51,0,-51
13196,1,0,9,0,-9
13197,1,0,63,0,-63
13198,1,1,319,1513,1194
13199,0,0,67,0,-67
13200,1,1,398,1611,1213
13201,1,1,293,1402,1109
13202,0,0,78,0,-78
13203,1,0,18,0,-18
13204,0,0,0,0,0
13205,0,0,3,0,-3
13206,0,0,58,0,-58
13207,0,0,31,0,-31
13208,1,0,37,0,-37
13209,1,0,25,0,-25
13210,1,0,3,0,-3
13211,0,0,5,0,-5
13212,1,0,235,0,-235
13213,1,1,1253,1675,422
13214,1,0,35,0,-35
13215,0,0,217,0,-217
13216,1,0,52,0,-52
13217,1,1,408,1771,1363
13218,1,0,9,0,-9
13219,1,1,52,1257,1205
13220,0,0,36,0,-36
13221,1,0,15,0,-15
13222,0,0,106,0,-106
13223,1,1,92,1336,1244
13224,1,0,9,0,-9
13225,1,1,554,1369,815
13226,0,0,5,0,-5
13227,1,0,9,0,-9
13228,1,1,173,1490,1317
13229,1,1,199,2538,2339
13230,1,0,164,0,-164
13231,1,1,233,1387,1154
13232,1,1,428,1250,822
13233,1,0,108,0,-108
13234,1,0,41,0,-41
13235,0,0,70,0,-70
13236,1,1,571,1206,635
13237,1,0,50,0,-50
13238,0,0,13,0,-13
13239,1,0,68,0,-68
13240,1,1,321,1544,1223
13241,1,1,298,1495,1197
13242,1,0,58,0,-58
13243,0,0,28,0,-28
13244,1,0,73,0,-73
13245,1,0,40,0,-40
13246,0,0,5,0,-5
13247,1,0,70,0,-70
13248,0,0,66,0,-66
13249,1,0,60,0,-60
13250,0,0,18,0,-18
13251,1,1,672,1316,644
13252,0,0,120,0,-120
13253,1,0,28,0,-28
13254,0,0,53,0,-53
13255,1,1,591,1294,703
13256,1,1,262,1840,1578
13257,1,1,859,1274,415
13258,1,1,387,1989,1602
13259,1,0,23,0,-23
13260,0,0,11,0,-11
13261,0,0,130,0,-130
13262,0,0,68,0,-68
13263,0,0,16,0,-16
13264,1,0,54,0,-54
13265,1,0,6,0,-6
13266,1,1,922,1210,288
13267,1,1,332,1846,1514
13268,0,0,23,0,-23
13269,0,0,33,0,-33
13270,1,0,48,0,-48
13271,0,0,99,0,-99
13272,1,0,129,0,-129
13273,0,0,42,0,-42
13274,0,0,11,0,-11
13275,1,0,30,0,-30
13276,0,0,12,0,-12
13277,1,1,301,1734,1433
13278,0,0,9,0,-9
13279,0,0,57,0,-57
13280,1,1,1788,1886,98
13281,1,0,68,0,-68
13282,1,1,103,1330,1227
13283,0,0,2,0,-2
13284,1,1,117,1919,1802
13285,1,0,6,0,-6
13286,1,0,111,0,-111
13287,1,0,48,0,-48
13288,0,0,98,0,-98
13289,0,0,20,0,-20
13290,0,0,64,0,-64
13291,1,1,1010,2160,1150
13292,1,1,67,1534,1467
13293,1,0,48,0,-48
13294,1,0,31,0,-31
13295,1,1,408,1267,859
13296,1,0,78,0,-78
13297,0,0,3,0,-3
13298,1,0,7,0,-7
13299,1,0,39,0,-39
13300,0,0,4,0,-4
13301,1,0,10,0,-10
13302,1,1,74,1479,1405
13303,0,0,19,0,-19
13304,0,0,19,0,-19
13305,1,1,89,1987,1898
13306,0,0,19,0,-19
13307,0,0,3,0,-3
13308,0,0,154,0,-154
13309,1,0,35,0,-35
13310,0,0,138,0,-138
13311,1,1,489,1347,858
13312,0,0,51,0,-51
13313,1,1,123,2067,1944
13314,1,1,448,1550,1102
13315,1,1,94,1766,1672
13316,1,0,0,0,0
13317,1,0,9,0,-9
13318,0,0,0,0,0
13319,1,1,166,1213,1047
13320,0,0,5,0,-5
13321,0,0,1,0,-1
13322,0,0,30,0,-30
13323,0,0,13,0,-13
13324,1,1,218,1432,1214
13325,1,0,0,0,0
13326,0,0,12,0,-12
13327,1,1,100,1381,1281
13328,1,0,40,0,-40
13329,1,1,502,1382,880
13330,0,0,19,0,-19
13331,1,0,49,0,-49
13332,1,0,7,0,-7
13333,1,1,565,1886,1321
13334,1,0,34,0,-34
13335,0,0,6,0,-6
13336,1,1,262,1449,1187
13337,0,0,11,0,-11
13338,0,0,83,0,-83
13339,1,0,19,0,-19
13340,1,0,148,0,-148
13341,0,0,12,0,-12
13342,1,0,32,0,-32
13343,0,0,28,0,-28
13344,1,1,112,1347,1235
13345,1,1,1316,2370,1054
13346,1,1,55,1241,1186
13347,0,0,9,0,-9
13348,1,1,169,2305,2136
13349,0,0,34,0,-34
13350,0,0,134,0,-134
13351,1,0,27,0,-27
13352,0,0,200,0,-200
13353,1,1,237,1250,1013
13354,1,0,11,0,-11
13355,1,0,105,0,-105
13356,1,0,49,0,-49
13357,1,0,119,0,-119
13358,0,0,9,0,-9
13359,0,0,0,0,0
13360,1,1,343,1236,893
13361,1,1,740,1577,837
13362,0,0,58,0,-58
13363,1,0,37,0,-37
13364,0,0,3,0,-3
13365,0,0,26,0,-26
13366,0,0,78,0,-78
13367,1,1,516,1224,708
13368,1,0,66,0,-66
13369,0,0,30,0,-30
13370,0,0,116,0,-116
13371,1,1,255,1347,1092
13372,1,0,29,0,-29
13373,1,0,17,0,-17
13374,1,1,69,1359,1290
13375,0,0,34,0,-34
13376,1,0,49,0,-49
13377,1,0,34,0,-34
13378,1,0,32,0,-32
13379,1,0,61,0,-61
13380,0,0,76,0,-76
13381,0,0,9,0,-9
13382,0,0,85,0,-85
13383,0,0,176,0,-176
13384,0,0,71,0,-71
13385,1,0,33,0,-33
13386,1,0,36,0,-36
13387,0,0,21,0,-21
13388,0,0,0,0,0
13389,1,0,11,0,-11
13390,1,1,228,1206,978
13391,1,0,86,0,-86
13392,1,0,71,0,-71
13393,1,1,99,1240,1141
13394,0,0,36,0,-36
13395,0,0,20,0,-20
13396,1,0,7,0,-7
13397,1,1,282,1715,1433
13398,0,0,28,0,-28
13399,0,0,50,0,-50
13400,0,0,38,0,-38
13401,0,0,33,0,-33
13402,0,0,12,0,-12
13403,1,0,38,0,-38
13404,0,0,13,0,-13
13405,1,1,341,1661,1320
13406,1,0,28,0,-28
13407,0,0,63,0,-63
13408,1,1,268,1273,1005
13409,1,1,300,1355,1055
13410,1,1,696,1334,638
13411,1,1,553,1517,964
13412,1,0,168,0,-168
13413,1,1,594,1523,929
13414,0,0,9,0,-9
13415,1,1,38,1737,1699
13416,1,1,696,1429,733
13417,0,0,62,0,-62
13418,0,0,42,0,-42
13419,1,1,1002,1201,199
13420,1,0,16,0,-16
13421,0,0,5,0,-5
13422,1,0,12,0,-12
13423,1,0,46,0,-46
13424,0,0,9,0,-9
13425,1,1,1418,1714,296
13426,0,0,6,0,-6
13427,1,0,6,0,-6
13428,0,0,75,0,-75
13429,1,0,4,0,-4
13430,1,1,1073,2708,1635
13431,1,0,16,0,-16
13432,1,0,0,0,0
13433,1,1,1123,1649,526
13434,1,1,744,1390,646
13435,1,1,840,1243,403
13436,0,0,15,0,-15
13437,1,1,540,3790,3250
13438,1,0,46,0,-46
13439,1,1,139,1263,1124
13440,0,0,46,0,-46
13441,0,0,11,0,-11
13442,1,1,409,1482,1073
13443,1,0,148,0,-148
13444,1,1,3665,1715,-1950
13445,1,1,452,2190,1738
13446,1,1,70,1211,1141
13447,1,0,32,0,-32
13448,1,0,110,0,-110
13449,1,0,55,0,-55
13450,1,1,1312,1865,553
13451,1,1,272,1337,1065
13452,1,1,205,1981,1776
13453,1,1,773,2608,1835
13454,0,0,8,0,-8
13455,1,0,27,0,-27
13456,1,1,768,1748,980
13457,0,0,122,0,-122
13458,1,0,98,0,-98
13459,1,0,6,0,-6
13460,0,0,131,0,-131
13461,1,0,14,0,-14
13462,0,0,8,0,-8
13463,1,1,1287,1734,447
13464,0,0,44,0,-44
13465,1,0,8,0,-8
13466,1,1,1541,1307,-234
13467,1,0,116,0,-116
13468,0,0,3,0,-3
13469,0,0,99,0,-99
13470,0,0,44,0,-44
13471,1,0,31,0,-31
13472,1,1,724,1267,543
13473,0,0,35,0,-35
13474,1,1,497,1347,850
13475,1,1,378,1521,1143
13476,0,0,28,0,-28
13477,1,1,1257,2196,939
13478,1,0,20,0,-20
13479,1,0,11,0,-11
13480,1,0,5,0,-5
13481,1,0,8,0,-8
13482,1,1,453,1254,801
13483,1,1,388,1302,914
13484,1,1,1074,1236,162
13485,0,0,12,0,-12
13486,1,0,46,0,-46
13487,0,0,11,0,-11
13488,0,0,20,0,-20
13489,1,0,29,0,-29
13490,1,1,545,1656,1111
13491,1,0,36,0,-36
13492,0,0,18,0,-18
13493,0,0,35,0,-35
13494,1,0,114,0,-114
13495,0,0,17,0,-17
13496,1,0,1,0,-1
13497,1,0,78,0,-78
13498,1,1,119,1273,1154
13499,0,0,70,0,-70
13500,1,1,106,1968,1862
13501,1,0,80,0,-80
13502,0,0,7,0,-7
13503,0,0,25,0,-25
13504,0,0,167,0,-167
13505,1,1,46,1404,1358
13506,1,1,373,1594,1221
13507,1,0,1,0,-1
13508,1,1,130,1367,1237
13509,0,0,8,0,-8
13510,1,0,37,0,-37
13511,1,1,2521,1275,-1246
13512,1,1,865,1221,356
13513,1,0,7,0,-7
13514,1,0,54,0,-54
13515,1,0,26,0,-26
13516,1,0,33,0,-33
13517,1,1,33,1370,1337
13518,0,0,102,0,-102
13519,0,0,33,0,-33
13520,0,0,44,0,-44
13521,0,0,2,0,-2
13522,1,1,102,1849,1747
13523,1,0,6,0,-6
13524,1,0,13,0,-13
13525,0,0,34,0,-34
13526,1,1,718,1776,1058
13527,1,0,52,0,-52
13528,1,1,213,1205,992
13529,1,1,258,1287,1029
13530,0,0,3,0,-3
13531,1,1,423,1571,1148
13532,1,0,17,0,-17
13533,1,1,711,1234,523
13534,1,1,478,1547,1069
13535,0,0,5,0,-5
13536,1,0,6,0,-6
13537,1,1,356,1785,1429
13538,1,0,241,0,-241
13539,0,0,77,0,-77
13540,1,1,271,1402,1131
13541,1,1,621,1817,1196
13542,0,0,73,0,-73
13543,1,0,33,0,-33
13544,1,0,17,0,-17
13545,0,0,62,0,-62
13546,0,0,46,0,-46
13547,0,0,55,0,-55
13548,1,1,74,1518,1444
13549,0,0,49,0,-49
13550,0,0,77,0,-77
13551,1,0,8,0,-8
13552,1,1,2820,1868,-952
13553,0,0,55,0,-55
13554,1,1,676,1456,780
13555,0,0,42,0,-42
13556,0,0,192,0,-192
13557,1,0,47,0,-47
13558,1,1,986,1481,495
13559,1,1,718,1604,886
13560,0,0,40,0,-40
13561,0,0,30,0,-30
13562,0,0,32,0,-32
13563,1,0,2,0,-2
13564,1,1,66,1360,1294
13565,1,0,140,0,-140
13566,1,1,481,1882,1401
13567,0,0,16,0,-16
13568,0,0,51,0,-51
13569,0,0,86,0,-86
13570,1,1,26,1900,1874
13571,1,1,176,1300,1124
13572,1,1,671,1649,978
13573,0,0,73,0,-73
13574,1,1,222,1523,1301
13575,0,0,58,0,-58
13576,1,1,1200,1309,109
13577,1,0,30,0,-30
13578,1,1,521,1239,718
13579,1,1,611,1270,659
13580,1,1,476,1748,1272
13581,1,0,2,0,-2
13582,0,0,1,0,-1
13583,1,1,150,1506,1356
13584,1,1,71,1414,1343
13585,0,0,34,0,-34
13586,0,0,14,0,-14
13587,1,0,35,0,-35
13588,1,0,84,0,-84
13589,1,0,14,0,-14
13590,1,1,202,1697,1495
13591,1,1,433,1492,1059
13592,0,0,10,0,-10
13593,1,1,486,1367,881
13594,0,0,24,0,-24
13595,1,0,26,0,-26
13596,1,0,4,0,-4
13597,1,0,31,0,-31
13598,0,0,46,0,-46
13599,0,0,102,0,-102
13600,0,0,87,0,-87
13601,1,1,758,1218,460
13602,0,0,108,0,-108
13603,1,0,69,0,-69
13604,1,0,120,0,-120
13605,0,0,93,0,-93
13606,0,0,38,0,-38
13607,1,0,46,0,-46
13608,1,1,154,1556,1402
13609,0,0,14,0,-14
13610,1,1,1170,1342,172
13611,1,0,150,0,-150
13612,0,0,62,0,-62
13613,0,0,20,0,-20
13614,0,0,110,0,-110
13615,1,0,94,0,-94
13616,1,1,495,1439,944
13617,0,0,22,0,-22
13618,0,0,29,0,-29
13619,1,0,58,0,-58
13620,1,1,233,1295,1062
13621,1,0,17,0,-17
13622,1,0,44,0,-44
13623,1,0,11,0,-11
13624,1,0,44,0,-44
13625,1,0,8,0,-8
13626,1,0,46,0,-46
13627,1,1,204,1309,1105
13628,0,0,61,0,-61
13629,1,0,0,0,0
13630,0,0,75,0,-75
13631,0,0,56,0,-56
13632,0,0,152,0,-152
13633,0,0,77,0,-77
13634,0,0,138,0,-138
13635,1,0,30,0,-30
13636,1,1,420,1205,785
13637,1,0,0,0,0
13638,1,1,488,3109,2621
13639,1,1,355,1377,1022
13640,1,1,54,1248,1194
13641,1,1,80,1299,1219
13642,1,1,420,1358,938
13643,0,0,127,0,-127
13644,1,0,16,0,-16
13645,1,0,45,0,-45
13646,1,0,91,0,-91
13647,0,0,62,0,-62
13648,1,1,583,1208,625
13649,0,0,33,0,-33
13650,1,0,9,0,-9
13651,0,0,52,0,-52
13652,0,0,116,0,-116
13653,1,1,2129,1261,-868
13654,1,0,70,0,-70
13655,1,0,225,0,-225
13656,1,1,419,1259,840
13657,0,0,65,0,-65
13658,1,0,137,0,-137
13659,0,0,0,0,0
13660,1,0,72,0,-72
13661,0,0,58,0,-58
13662,1,0,47,0,-47
13663,0,0,46,0,-46
13664,1,0,1,0,-1
13665,0,0,3,0,-3
13666,0,0,203,0,-203
13667,1,1,50,1262,1212
13668,1,1,491,1257,766
13669,1,1,55,1664,1609
13670,1,1,282,7912,7630
13671,1,0,198,0,-198
13672,0,0,56,0,-56
13673,0,0,44,0,-44
13674,1,1,151,1252,1101
13675,0,0,15,0,-15
13676,1,1,28,2096,2068
13677,1,1,367,2319,1952
13678,1,0,41,0,-41
13679,0,0,24,0,-24
13680,0,0,28,0,-28
13681,0,0,50,0,-50
13682,1,1,254,1688,1434
13683,0,0,18,0,-18
13684,0,0,24,0,-24
13685,1,0,49,0,-49
13686,0,0,76,0,-76
13687,0,0,3,0,-3
13688,0,0,40,0,-40
13689,0,0,143,0,-143
13690,1,1,1607,1490,-117
13691,1,0,59,0,-59
13692,0,0,24,0,-24
13693,0,0,32,0,-32
13694,0,0,13,0,-13
13695,1,1,159,1287,1128
13696,1,0,37,0,-37
13697,0,0,24,0,-24
13698,1,1,293,1797,1504
13699,1,0,22,0,-22
13700,0,0,30,0,-30
13701,1,1,435,1271,836
13702,0,0,3,0,-3
13703,0,0,1,0,-1
13704,1,0,38,0,-38
13705,1,0,3,0,-3
13706,0,0,53,0,-53
13707,1,1,1023,1476,453
13708,0,0,17,0,-17
13709,1,0,13,0,-13
13710,0,0,28,0,-28
13711,0,0,7,0,-7
13712,1,1,541,1515,974
13713,1,0,259,0,-259
13714,1,1,387,1340,953
13715,1,0,46,0,-46
13716,0,0,159,0,-159
13717,1,0,13,0,-13
13718,1,0,147,0,-147
13719,1,1,1249,1427,178
13720,1,0,144,0,-144
13721,0,0,103,0,-103
13722,1,0,80,0,-80
13723,0,0,173,0,-173
13724,0,0,47,0,-47
13725,1,0,18,0,-18
13726,1,0,65,0,-65
13727,0,0,57,0,-57
13728,1,1,149,1259,1110
13729,0,0,44,0,-44
13730,1,1,412,1330,918
13731,0,0,226,0,-226
13732,1,0,4,0,-4
13733,0,0,8,0,-8
13734,1,1,877,1217,340
13735,1,0,193,0,-193
13736,0,0,1,0,-1
13737,1,1,2062,2110,48
13738,0,0,10,0,-10
13739,1,0,2,0,-2
13740,1,0,20,0,-20
13741,1,1,26,1827,1801
13742,0,0,27,0,-27
13743,1,1,390,2461,2071
13744,1,0,16,0,-16
13745,0,0,21,0,-21
13746,1,1,58,1939,1881
13747,0,0,11,0,-11
13748,1,1,83,1789,1706
13749,1,1,86,1300,1214
13750,1,1,280,1222,942
13751,1,1,135,2413,2278
13752,0,0,64,0,-64
13753,0,0,105,0,-105
13754,0,0,135,0,-135
13755,1,0,93,0,-93
13756,0,0,146,0,-146
13757,1,0,28,0,-28
13758,1,0,95,0,-95
13759,0,0,103,0,-103
13760,1,1,374,1328,954
13761,1,1,340,1204,864
13762,1,0,49,0,-49
13763,1,0,26,0,-26
13764,1,0,13,0,-13
13765,1,0,9,0,-9
13766,1,0,42,0,-42
13767,1,0,14,0,-14
13768,0,0,1,0,-1
13769,0,0,111,0,-111
13770,1,1,121,1793,1672
13771,1,1,261,1603,1342
13772,1,0,17,0,-17
13773,1,0,172,0,-172
13774,1,0,210,0,-210
13775,1,0,42,0,-42
13776,1,1,340,3071,2731
13777,1,0,2,0,-2
13778,0,0,59,0,-59
13779,1,0,80,0,-80
13780,0,0,17,0,-17
13781,1,0,290,0,-290
13782,0,0,98,0,-98
13783,0,0,47,0,-47
13784,1,1,436,1278,842
13785,1,0,6,0,-6
13786,0,0,1,0,-1
13787,0,0,119,0,-119
13788,1,1,320,1208,888
13789,1,0,52,0,-52
13790,0,0,257,0,-257
13791,0,0,26,0,-26
13792,1,0,9,0,-9
13793,1,1,443,1457,1014
13794,0,0,45,0,-45
13795,0,0,14,0,-14
13796,1,1,148,1304,1156
13797,1,1,1059,1326,267
13798,1,1,527,2641,2114
13799,1,1,485,2115,1630
13800,1,0,9,0,-9
13801,1,1,761,2684,1923
13802,0,0,35,0,-35
13803,0,0,30,0,-30
13804,1,0,47,0,-47
13805,1,0,113,0,-113
13806,0,0,8,0,-8
13807,1,0,68,0,-68
13808,1,0,43,0,-43
13809,1,1,701,1207,506
13810,1,1,10,2470,2460
13811,1,0,53,0,-53
13812,0,0,41,0,-41
13813,1,1,86,2139,2053
13814,0,0,30,0,-30
13815,1,1,757,1318,561
13816,1,1,217,4118,3901
13817,1,0,66,0,-66
13818,0,0,35,0,-35
13819,1,1,216,1399,1183
13820,1,1,112,1508,1396
13821,1,1,215,1410,1195
13822,0,0,8,0,-8
13823,1,0,94,0,-94
13824,0,0,136,0,-136
13825,0,0,45,0,-45
13826,1,1,1710,2025,315
13827,1,1,662,1388,726
13828,1,0,76,0,-76
13829,0,0,69,0,-69
13830,1,1,627,1520,893
13831,0,0,2,0,-2
13832,0,0,8,0,-8
13833,0,0,6,0,-6
13834,1,0,53,0,-53
13835,1,0,91,0,-91
13836,0,0,1,0,-1
13837,0,0,38,0,-38
13838,1,1,934,1406,472
13839,0,0,22,0,-22
13840,0,0,39,0,-39
13841,1,0,83,0,-83
13842,1,1,352,2764,2412
13843,1,0,71,0,-71
13844,0,0,9,0,-9
13845,0,0,64,0,-64
13846,0,0,69,0,-69
13847,1,1,358,1419,1061
13848,1,1,65,1204,1139
13849,1,1,55,1271,1216
13850,0,0,31,0,-31
13851,1,0,57,0,-57
13852,1,0,149,0,-149
13853,1,0,0,0,0
13854,1,0,239,0,-239
13855,1,1,360,1537,1177
13856,1,0,10,0,-10
13857,1,1,187,1351,1164
13858,1,1,1054,1510,456
13859,0,0,55,0,-55
13860,1,0,3,0,-3
13861,0,0,74,0,-74
13862,0,0,14,0,-14
13863,1,1,570,1410,840
13864,1,0,20,0,-20
13865,1,1,617,1318,701
13866,0,0,90,0,-90
13867,1,1,154,1644,1490
13868,1,0,16,0,-16
13869,1,1,1287,2260,973
13870,1,1,292,1782,1490
13871,0,0,90,0,-90
13872,0,0,71,0,-71
13873,1,1,96,1316,1220
13874,1,1,220,1355,1135
13875,0,0,101,0,-101
13876,1,1,2944,1635,-1309
13877,1,1,79,1278,1199
13878,1,1,399,1270,871
13879,1,1,377,1687,1310
13880,1,0,32,0,-32
13881,0,0,93,0,-93
13882,0,0,44,0,-44
13883,0,0,14,0,-14
13884,0,0,26,0,-26
13885,0,0,99,0,-99
13886,1,1,27,1368,1341
13887,0,0,16,0,-16
13888,0,0,7,0,-7
13889,1,0,41,0,-41
13890,0,0,8,0,-8
13891,0,0,1,0,-1
13892,1,0,6,0,-6
13893,1,1,463,1692,1229
13894,1,1,392,1619,1227
13895,1,1,331,1250,919
13896,1,1,368,1225,857
13897,1,1,251,1227,976
13898,0,0,133,0,-133
13899,1,1,162,1737,1575
13900,1,0,48,0,-48
13901,1,1,576,1209,633
13902,1,0,39,0,-39
13903,1,0,32,0,-32
13904,1,0,14,0,-14
13905,1,1,66,1228,1162
13906,0,0,17,0,-17
13907,1,1,78,2620,2542
13908,1,1,448,1579,1131
13909,0,0,123,0,-123
13910,1,0,109,0,-109
13911,0,0,58,0,-58
13912,1,0,20,0,-20
13913,0,0,103,0,-103
13914,1,1,244,1297,1053
13915,0,0,17,0,-17
13916,1,0,51,0,-51
13917,0,0,19,0,-19
13918,0,0,2,0,-2
13919,0,0,102,0,-102
13920,0,0,6,0,-6
13921,1,0,53,0,-53
13922,1,0,10,0,-10
13923,1,0,42,0,-42
13924,1,0,22,0,-22
13925,1,1,213,1377,1164
13926,0,0,61,0,-61
13927,1,1,273,1359,1086
13928,0,0,89,0,-89
13929,1,1,424,1241,817
13930,1,0,1,0,-1
13931,1,0,8,0,-8
13932,1,0,1,0,-1
13933,1,0,25,0,-25
13934,0,0,12,0,-12
13935,0,0,26,0,-26
13936,1,1,88,1350,1262
13937,0,0,6,0,-6
13938,0,0,36,0,-36
13939,1,1,304,1485,1181
13940,1,0,19,0,-19
13941,0,0,69,0,-69
13942,1,1,264,1622,1358
13943,1,0,40,0,-40
13944,1,1,150,2187,2037
13945,0,0,38,0,-38
13946,1,0,1,0,-1
13947,0,0,145,0,-145
13948,1,1,52,1364,1312
13949,0,0,1,0,-1
13950,0,0,10,0,-10
13951,1,0,6,0,-6
13952,0,0,65,0,-65
13953,1,1,1039,1453,414
13954,1,1,20,1267,1247
13955,0,0,7,0,-7
13956,1,1,810,1918,1108
13957,0,0,19,0,-19
13958,1,0,20,0,-20
13959,0,0,136,0,-136
13960,1,0,59,0,-59
13961,1,1,242,1518,1276
13962,1,0,53,0,-53
13963,1,0,56,0,-56
13964,0,0,62,0,-62
13965,1,0,31,0,-31
13966,1,1,111,1935,1824
13967,0,0,21,0,-21
13968,1,1,58,1540,1482
13969,1,0,23,0,-23
13970,1,1,147,1368,1221
13971,0,0,28,0,-28
13972,1,1,255,1216,961
13973,1,1,358,1230,872
13974,1,0,99,0,-99
13975,0,0,8,0,-8
13976,1,0,33,0,-33
13977,1,0,8,0,-8
13978,1,0,51,0,-51
13979,1,0,1,0,-1
13980,1,1,132,1242,1110
13981,0,0,28,0,-28
13982,0,0,127,0,-127
13983,1,0,0,0,0
13984,1,1,81,1489,1408
13985,1,1,492,1347,855
13986,0,0,90,0,-90
13987,0,0,46,0,-46
13988,1,1,458,1285,827
13989,1,0,46,0,-46
13990,1,1,1006,1211,205
13991,1,0,55,0,-55
13992,0,0,22,0,-22
13993,1,0,34,0,-34
13994,0,0,34,0,-34
13995,1,0,3,0,-3
13996,0,0,115,0,-115
13997,0,0,37,0,-37
13998,1,0,26,0,-26
13999,0,0,8,0,-8
14000,1,1,1004,1284,280
14001,1,1,180,1221,1041
14002,1,0,7,0,-7
14003,1,1,115,3199,3084
14004,1,0,5,0,-5
14005,1,1,576,1247,671
14006,1,1,1001,1381,380
14007,1,1,224,1200,976
14008,0,0,4,0,-4
14009,1,0,4,0,-4
14010,0,0,22,0,-22
14011,0,0,115,0,-115
14012,1,1,42,1283,1241
14013,1,1,178,1675,1497
14014,0,0,27,0,-27
14015,1,1,81,1590,1509
14016,1,0,18,0,-18
14017,1,0,75,0,-75
14018,0,0,1,0,-1
14019,0,0,88,0,-88
14020,0,0,4,0,-4
14021,1,1,567,1519,952
14022,0,0,64,0,-64
14023,1,0,42,0,-42
14024,0,0,5,0,-5
14025,1,1,273,1284,1011
14026,0,0,26,0,-26
14027,1,1,850,3633,2783
14028,0,0,55,0,-55
14029,1,0,2,0,-2
14030,0,0,22,0,-22
14031,0,0,173,0,-173
14032,0,0,114,0,-114
14033,1,0,13,0,-13
14034,0,0,50,0,-50
14035,1,1,177,1526,1349
14036,0,0,24,0,-24
14037,1,0,5,0,-5
14038,0,0,314,0,-314
14039,1,0,12,0,-12
14040,0,0,15,0,-15
14041,0,0,32,0,-32
14042,1,0,29,0,-29
14043,0,0,2,0,-2
14044,1,1,658,1233,575
14045,0,0,5,0,-5
14046,1,0,51,0,-51
14047,1,1,389,1586,1197
14048,0,0,57,0,-57
14049,1,1,549,1369,820
14050,0,0,2,0,-2
14051,0,0,21,0,-21
14052,0,0,8,0,-8
14053,0,0,19,0,-19
14054,1,0,18,0,-18
14055,1,1,1908,1205,-703
14056,0,0,8,0,-8
14057,1,1,984,1533,549
14058,1,1,507,1504,997
14059,0,0,66,0,-66
14060,0,0,10,0,-10
14061,1,1,294,10059,9765
14062,1,1,458,1282,824
14063,0,0,34,0,-34
14064,1,0,17,0,-17
14065,0,0,99,0,-99
14066,1,0,195,0,-195
14067,0,0,57,0,-57
14068,0,0,6,0,-6
14069,1,0,33,0,-33
14070,1,0,141,0,-141
14071,1,1,385,1390,1005
14072,1,1,492,1272,780
14073,0,0,1,0,-1
14074,1,1,521,1268,747
14075,1,1,658,1213,555
14076,1,0,26,0,-26
14077,0,0,89,0,-89
14078,1,0,20,0,-20
14079,1,1,132,1501,1369
14080,0,0,89,0,-89
14081,0,0,28,0,-28
14082,1,1,175,1226,1051
14083,0,0,29,0,-29
14084,1,1,264,1757,1493
14085,1,0,84,0,-84
14086,1,1,1125,1896,771
14087,1,0,14,0,-14
14088,1,0,35,0,-35
14089,0,0,57,0,-57
14090,0,0,1,0,-1
14091,0,0,56,0,-56
14092,1,1,578,1784,1206
14093,1,0,9,0,-9
14094,1,1,573,1207,634
14095,1,1,120,1229,1109
14096,0,0,10,0,-10
14097,1,1,636,1771,1135
14098,0,0,97,0,-97
14099,1,1,486,1394,908
14100,1,1,1253,3727,2474
14101,1,0,13,0,-13
14102,1,1,414,1949,1535
14103,0,0,47,0,-47
14104,1,0,91,0,-91
14105,1,0,123,0,-123
14106,1,0,99,0,-99
14107,1,1,106,1248,1142
14108,1,1,460,1380,920
14109,0,0,66,0,-66
14110,1,0,241,0,-241
14111,1,0,57,0,-57
14112,1,0,38,0,-38
14113,1,0,104,0,-104
14114,1,0,181,0,-181
14115,1,0,68,0,-68
14116,1,0,32,0,-32
14117,0,0,18,0,-18
14118,1,1,991,1204,213
14119,0,0,34,0,-34
14120,1,1,696,1377,681
14121,0,0,104,0,-104
14122,1,1,380,1309,929
14123,0,0,32,0,-32
14124,1,1,358,1427,1069
14125,1,1,1241,1480,239
14126,0,0,55,0,-55
14127,0,0,78,0,-78
14128,1,1,121,1634,1513
14129,0,0,58,0,-58
14130,0,0,52,0,-52
14131,1,1,637,1304,667
14132,1,1,52,1371,1319
14133,0,0,103,0,-103
14134,1,0,144,0,-144
14135,1,1,276,1744,1468
14136,1,1,471,1249,778
14137,1,0,69,0,-69
14138,0,0,188,0,-188
14139,0,0,58,0,-58
14140,1,1,287,1706,1419
14141,0,0,122,0,-122
14142,0,0,49,0,-49
14143,1,0,3,0,-3
14144,0,0,38,0,-38
14145,0,0,51,0,-51
14146,1,1,1684,1280,-404
14147,0,0,51,0,-51
14148,1,0,11,0,-11
14149,1,0,97,0,-97
14150,1,1,144,1338,1194
14151,1,0,182,0,-182
14152,0,0,38,0,-38
14153,1,1,391,1995,1604
14154,1,1,868,1355,487
14155,1,1,150,1490,1340
14156,1,1,261,1281,1020
14157,0,0,5,0,-5
14158,0,0,12,0,-12
14159,0,0,21,0,-21
14160,1,1,302,1389,1087
14161,0,0,209,0,-209
14162,0,0,22,0,-22
14163,0,0,80,0,-80
14164,1,1,344,1275,931
14165,1,0,57,0,-57
14166,1,0,63,0,-63
14167,1,0,13,0,-13
14168,1,1,354,1207,853
14169,1,0,45,0,-45
14170,1,0,58,0,-58
14171,0,0,13,0,-13
14172,1,0,178,0,-178
14173,1,0,56,0,-56
14174,1,1,134,1419,1285
14175,1,1,139,1477,1338
14176,1,1,618,1476,858
14177,0,0,68,0,-68
14178,1,1,176,1316,1140
14179,0,0,133,0,-133
14180,0,0,55,0,-55
14181,0,0,137,0,-137
14182,1,1,393,1514,1121
14183,0,0,1,0,-1
14184,0,0,52,0,-52
14185,0,0,35,0,-35
14186,0,0,151,0,-151
14187,1,0,17,0,-17
14188,1,1,398,1921,1523
14189,1,1,240,1426,1186
14190,1,1,165,2414,2249
14191,0,0,26,0,-26
14192,1,0,38,0,-38
14193,1,1,862,1379,517
14194,1,0,20,0,-20
14195,1,0,12,0,-12
14196,1,1,169,1327,1158
14197,1,1,1075,1402,327
14198,0,0,5,0,-5
14199,1,1,267,1321,1054
14200,0,0,3,0,-3
14201,1,0,115,0,-115
14202,1,1,1092,1294,202
14203,1,1,169,1236,1067
14204,1,1,63,1955,1892
14205,0,0,11,0,-11
14206,1,0,20,0,-20
14207,1,1,454,1224,770
14208,0,0,270,0,-270
14209,1,1,77,1597,1520
14210,1,0,102,0,-102
14211,0,0,30,0,-30
14212,1,1,50,2904,2854
14213,0,0,31,0,-31
14214,1,0,220,0,-220
14215,1,1,127,1239,1112
14216,1,0,56,0,-56
14217,1,0,31,0,-31
14218,1,0,4,0,-4
14219,1,0,59,0,-59
14220,0,0,47,0,-47
14221,0,0,113,0,-113
14222,1,0,74,0,-74
14223,1,1,836,2008,1172
14224,0,0,16,0,-16
14225,1,0,17,0,-17
14226,1,1,105,1267,1162
14227,1,1,1261,1787,526
14228,0,0,39,0,-39
14229,0,0,165,0,-165
14230,0,0,97,0,-97
14231,1,0,4,0,-4
14232,1,1,380,1590,1210
14233,0,0,19,0,-19
14234,1,0,0,0,0
14235,1,1,76,2359,2283
14236,1,0,2,0,-2
14237,0,0,13,0,-13
14238,1,0,12,0,-12
14239,1,1,1571,1495,-76
14240,1,0,79,0,-79
14241,1,1,273,1347,1074
14242,0,0,28,0,-28
14243,1,0,0,0,0
14244,0,0,145,0,-145
14245,1,1,485,1206,721
14246,1,1,1087,1652,565
14247,1,1,191,1295,1104
14248,0,0,14,0,-14
14249,0,0,17,0,-17
14250,1,1,639,1347,708
14251,0,0,6,0,-6
14252,0,0,27,0,-27
14253,0,0,38,0,-38
14254,1,0,9,0,-9
14255,1,0,1,0,-1
14256,1,0,58,0,-58
14257,0,0,57,0,-57
14258,0,0,6,0,-6
14259,1,0,50,0,-50
14260,0,0,62,0,-62
14261,1,0,148,0,-148
14262,1,1,155,1244,1089
14263,1,0,12,0,-12
14264,1,0,99,0,-99
14265,1,0,19,0,-19
14266,1,1,426,1376,950
14267,0,0,64,0,-64
14268,1,1,351,1429,1078
14269,1,1,169,1419,1250
14270,1,0,20,0,-20
14271,1,0,75,0,-75
14272,1,1,675,1368,693
14273,0,0,70,0,-70
14274,0,0,183,0,-183
14275,1,1,475,1856,1381
14276,1,1,1250,2167,917
14277,1,1,83,2524,2441
14278,1,1,423,1652,1229
14279,1,0,6,0,-6
14280,0,0,18,0,-18
14281,1,1,185,1468,1283
14282,1,0,9,0,-9
14283,1,0,74,0,-74
14284,1,1,31,1244,1213
14285,0,0,24,0,-24
14286,0,0,15,0,-15
14287,1,0,95,0,-95
14288,1,1,691,1377,686
14289,1,1,1205,1262,57
14290,1,1,1626,3357,1731
14291,1,1,424,1490,1066
14292,0,0,38,0,-38
14293,1,1,656,2168,1512
14294,1,1,693,1926,1233
14295,0,0,115,0,-115
14296,1,0,51,0,-51
14297,1,1,927,1648,721
14298,0,0,43,0,-43
14299,1,0,37,0,-37
14300,1,0,5,0,-5
14301,0,0,106,0,-106
14302,1,1,1327,2252,925
14303,1,0,8,0,-8
14304,1,0,54,0,-54
14305,1,0,159,0,-159
14306,0,0,166,0,-166
14307,1,1,106,1991,1885
14308,0,0,2,0,-2
14309,1,0,38,0,-38
14310,1,1,846,1406,560
14311,0,0,5,0,-5
14312,0,0,76,0,-76
14313,0,0,81,0,-81
14314,1,1,874,1218,344
14315,0,0,56,0,-56
14316,1,0,184,0,-184
14317,1,1,898,2240,1342
14318,0,0,24,0,-24
14319,0,0,29,0,-29
14320,1,0,64,0,-64
14321,0,0,30,0,-30
14322,1,0,12,0,-12
14323,1,1,275,1613,1338
14324,1,0,81,0,-81
14325,1,0,48,0,-48
14326,0,0,110,0,-110
14327,0,0,15,0,-15
14328,0,0,4,0,-4
14329,1,0,67,0,-67
14330,1,0,22,0,-22
14331,1,1,126,1318,1192
14332,0,0,7,0,-7
14333,1,0,78,0,-78
14334,1,0,69,0,-69
14335,0,0,66,0,-66
14336,0,0,22,0,-22
14337,1,1,1099,1507,408
14338,0,0,102,0,-102
14339,0,0,33,0,-33
14340,0,0,138,0,-138
14341,1,1,447,2160,1713
14342,0,0,5,0,-5
14343,1,1,383,3101,2718
14344,1,0,60,0,-60
14345,0,0,78,0,-78
14346,1,0,24,0,-24
14347,1,1,399,1515,1116
14348,1,1,1838,1403,-435
14349,1,1,123,2062,1939
14350,0,0,41,0,-41
14351,1,1,798,1236,438
14352,0,0,80,0,-80
14353,1,1,782,2000,1218
14354,1,1,176,4383,4207
14355,0,0,10,0,-10
14356,1,0,57,0,-57
14357,1,0,152,0,-152
14358,1,0,5,0,-5
14359,1,1,130,1497,1367
14360,1,1,754,1510,756
14361,0,0,5,0,-5
14362,1,1,92,1831,1739
14363,0,0,20,0,-20
14364,1,0,56,0,-56
14365,0,0,4,0,-4
14366,0,0,36,0,-36
14367,0,0,36,0,-36
14368,0,0,45,0,-45
14369,0,0,139,0,-139
14370,0,0,37,0,-37
14371,1,0,32,0,-32
14372,1,0,54,0,-54
14373,1,1,244,1247,1003
14374,1,1,29,1321,1292
14375,1,0,18,0,-18
14376,1,1,478,1310,832
14377,1,1,229,1303,1074
14378,1,1,1172,1300,128
14379,1,0,6,0,-6
14380,1,0,31,0,-31
14381,1,0,9,0,-9
14382,0,0,24,0,-24
14383,1,1,1447,1393,-54
14384,0,0,95,0,-95
14385,0,0,82,0,-82
14386,0,0,137,0,-137
14387,0,0,38,0,-38
14388,1,0,27,0,-27
14389,1,1,1136,1622,486
14390,1,0,53,0,-53
14391,0,0,210,0,-210
14392,0,0,19,0,-19
14393,1,1,249,1609,1360
14394,1,1,425,1238,813
14395,1,1,282,1213,931
14396,0,0,17,0,-17
14397,0,0,151,0,-151
14398,1,0,81,0,-81
14399,1,0,0,0,0
14400,1,0,104,0,-104
14401,1,1,1262,1269,7
14402,1,0,95,0,-95
14403,1,0,39,0,-39
14404,0,0,33,0,-33
14405,1,1,392,1210,818
14406,1,0,52,0,-52
14407,0,0,43,0,-43
14408,1,0,300,0,-300
14409,1,1,481,5852,5371
14410,1,0,14,0,-14
14411,0,0,13,0,-13
14412,0,0,28,0,-28
14413,1,0,56,0,-56
14414,1,0,35,0,-35
14415,1,0,53,0,-53
14416,1,1,697,1293,596
14417,0,0,28,0,-28
14418,1,0,11,0,-11
14419,0,0,63,0,-63
14420,0,0,6,0,-6
14421,1,0,9,0,-9
14422,1,1,110,1382,1272
14423,1,0,58,0,-58
14424,1,1,410,1260,850
14425,1,1,736,1933,1197
14426,1,1,1067,1214,147
14427,1,1,709,1755,1046
14428,1,0,30,0,-30
14429,1,0,54,0,-54
14430,1,1,662,1358,696
14431,0,0,13,0,-13
14432,1,1,124,1219,1095
14433,1,1,216,1618,1402
14434,1,0,100,0,-100
14435,0,0,46,0,-46
14436,0,0,12,0,-12
14437,1,1,52,1249,1197
14438,0,0,61,0,-61
14439,1,0,4,0,-4
14440,1,0,66,0,-66
14441,1,0,50,0,-50
14442,1,1,882,1533,651
14443,1,0,13,0,-13
14444,1,0,104,0,-104
14445,1,1,523,1269,746
14446,1,0,14,0,-14
14447,1,1,307,1830,1523
14448,1,0,94,0,-94
14449,0,0,0,0,0
14450,0,0,1,0,-1
14451,1,1,113,1436,1323
14452,0,0,0,0,0
14453,0,0,0,0,0
14454,0,0,24,0,-24
14455,0,0,9,0,-9
14456,1,1,1078,1285,207
14457,0,0,13,0,-13
14458,0,0,23,0,-23
14459,1,1,418,1654,1236
14460,1,0,50,0,-50
14461,1,1,260,1526,1266
14462,1,0,145,0,-145
14463,0,0,0,0,0
14464,0,0,0,0,0
14465,0,0,29,0,-29
14466,1,1,344,1468,1124
14467,1,0,45,0,-45
14468,1,1,90,1450,1360
14469,1,0,21,0,-21
14470,1,0,13,0,-13
14471,0,0,6,0,-6
14472,0,0,61,0,-61
14473,1,1,855,1354,499
14474,1,0,57,0,-57
14475,1,0,127,0,-127
14476,0,0,171,0,-171
14477,1,1,1684,1612,-72
14478,1,0,135,0,-135
14479,1,1,143,2330,2187
14480,0,0,11,0,-11
14481,1,0,28,0,-28
14482,0,0,4,0,-4
14483,0,0,1,0,-1
14484,0,0,80,0,-80
14485,1,0,237,0,-237
14486,1,1,337,1370,1033
14487,1,1,442,1797,1355
14488,1,0,150,0,-150
14489,0,0,39,0,-39
14490,1,1,638,1340,702
14491,1,1,815,1573,758
14492,1,0,87,0,-87
14493,1,0,33,0,-33
14494,1,0,21,0,-21
14495,0,0,1,0,-1
14496,1,0,47,0,-47
14497,0,0,62,0,-62
14498,1,1,578,1201,623
14499,1,1,243,1353,1110
14500,0,0,42,0,-42
14501,0,0,90,0,-90
14502,0,0,59,0,-59
14503,1,1,489,1939,1450
14504,1,1,394,2336,1942
14505,1,1,40,1585,1545
14506,1,0,64,0,-64
14507,0,0,29,0,-29
14508,1,0,47,0,-47
14509,0,0,14,0,-14
14510,1,0,25,0,-25
14511,1,1,548,2280,1732
14512,0,0,9,0,-9
14513,1,0,21,0,-21
14514,1,0,12,0,-12
14515,0,0,24,0,-24
14516,0,0,5,0,-5
14517,0,0,23,0,-23
14518,0,0,64,0,-64
14519,1,1,1325,1938,613
14520,1,0,8,0,-8
14521,0,0,66,0,-66
14522,0,0,3,0,-3
14523,1,0,13,0,-13
14524,1,1,213,1318,1105
14525,0,0,83,0,-83
14526,1,1,222,1750,1528
14527,0,0,84,0,-84
14528,1,0,57,0,-57
14529,1,0,33,0,-33
14530,0,0,9,0,-9
14531,0,0,18,0,-18
14532,1,0,28,0,-28
14533,0,0,12,0,-12
14534,1,1,1490,1283,-207
14535,1,1,92,1348,1256
14536,0,0,15,0,-15
14537,1,1,630,1360,730
14538,1,1,241,2688,2447
14539,0,0,8,0,-8
14540,0,0,64,0,-64
14541,0,0,37,0,-37
14542,1,1,272,1615,1343
14543,0,0,74,0,-74
14544,1,1,668,1645,977
14545,0,0,169,0,-169
14546,0,0,16,0,-16
14547,0,0,23,0,-23
14548,1,0,26,0,-26
14549,0,0,50,0,-50
14550,1,0,6,0,-6
14551,1,1,87,1392,1305
14552,1,1,185,1439,1254
14553,1,0,20,0,-20
14554,0,0,146,0,-146
14555,0,0,59,0,-59
14556,1,0,82,0,-82
14557,0,0,80,0,-80
14558,1,0,46,0,-46
14559,1,1,224,1304,1080
14560,0,0,1,0,-1
14561,1,1,569,1297,728
14562,1,1,277,3286,3009
14563,0,0,5,0,-5
14564,1,1,171,1222,1051
14565,1,0,38,0,-38
14566,1,1,142,1253,1111
14567,1,1,219,1348,1129
14568,1,0,10,0,-10
14569,1,1,84,1221,1137
14570,0,0,109,0,-109
14571,1,1,590,1215,625
14572,1,0,1,0,-1
14573,0,0,2,0,-2
14574,1,0,21,0,-21
14575,1,1,279,1495,1216
14576,1,1,1517,2077,560
14577,1,0,46,0,-46
14578,1,1,177,3046,2869
14579,0,0,49,0,-49
14580,0,0,20,0,-20
14581,1,1,890,1697,807
14582,1,1,72,1822,1750
14583,1,0,6,0,-6
14584,0,0,58,0,-58
14585,1,0,5,0,-5
14586,0,0,32,0,-32
14587,1,1,142,1416,1274
14588,1,1,271,2688,2417
14589,1,1,254,1423,1169
14590,1,1,114,1249,1135
14591,1,1,1396,1507,111
14592,0,0,70,0,-70
14593,1,0,45,0,-45
14594,0,0,86,0,-86
14595,1,0,10,0,-10
14596,1,0,15,0,-15
14597,0,0,224,0,-224
14598,0,0,107,0,-107
14599,1,0,133,0,-133
14600,1,1,669,1603,934
14601,1,0,6,0,-6
14602,0,0,8,0,-8
14603,1,0,8,0,-8
14604,0,0,15,0,-15
14605,1,1,235,1745,1510
14606,1,0,51,0,-51
14607,1,1,316,1415,1099
14608,0,0,145,0,-145
14609,1,1,72,1389,1317
14610,1,1,1600,1216,-384
14611,1,0,56,0,-56
14612,1,0,24,0,-24
14613,1,1,438,1235,797
14614,1,1,320,1499,1179
14615,1,1,1614,2210,596
14616,1,1,1038,1216,178
14617,1,1,372,1709,1337
14618,1,0,30,0,-30
14619,0,0,30,0,-30
14620,1,1,593,3675,3082
14621,1,1,195,1291,1096
14622,1,0,57,0,-57
14623,1,1,673,1331,658
14624,0,0,121,0,-121
14625,1,0,13,0,-13
14626,0,0,27,0,-27
14627,1,1,849,1286,437
14628,0,0,13,0,-13
14629,0,0,13,0,-13
14630,1,0,115,0,-115
14631,1,0,50,0,-50
14632,0,0,16,0,-16
14633,0,0,46,0,-46
14634,1,1,1403,1520,117
14635,1,1,206,1680,1474
14636,1,1,647,1238,591
14637,1,1,147,1363,1216
14638,1,0,21,0,-21
14639,0,0,77,0,-77
14640,0,0,132,0,-132
14641,0,0,98,0,-98
14642,1,0,16,0,-16
14643,0,0,54,0,-54
14644,1,1,318,1334,1016
14645,0,0,18,0,-18
14646,0,0,101,0,-101
14647,0,0,70,0,-70
14648,0,0,10,0,-10
14649,1,1,1490,1524,34
14650,1,1,698,1452,754
14651,1,1,297,1975,1678
14652,0,0,30,0,-30
14653,1,1,1159,1332,173
14654,1,0,58,0,-58
14655,1,0,83,0,-83
14656,1,1,301,1351,1050
14657,0,0,63,0,-63
14658,1,0,42,0,-42
14659,1,0,30,0,-30
14660,1,0,17,0,-17
14661,0,0,9,0,-9
14662,0,0,1,0,-1
14663,1,0,15,0,-15
14664,1,0,172,0,-172
14665,0,0,12,0,-12
14666,1,1,153,1586,1433
14667,1,1,116,1470,1354
14668,1,1,580,1236,656
14669,0,0,141,0,-141
14670,0,0,47,0,-47
14671,0,0,1,0,-1
14672,1,0,20,0,-20
14673,0,0,16,0,-16
14674,0,0,38,0,-38
14675,1,1,422,2557,2135
14676,1,1,393,1507,1114
14677,1,0,38,0,-38
14678,1,1,399,1582,1183
14679,0,0,0,0,0
14680,1,1,1772,1385,-387
14681,1,1,840,2697,1857
14682,1,0,17,0,-17
14683,1,1,455,2495,2040
14684,0,0,5,0,-5
14685,1,1,536,1428,892
14686,0,0,10,0,-10
14687,0,0,49,0,-49
14688,0,0,86,0,-86
14689,1,0,41,0,-41
14690,1,0,46,0,-46
14691,0,0,14,0,-14
14692,0,0,40,0,-40
14693,1,0,17,0,-17
14694,1,0,7,0,-7
14695,1,1,150,1221,1071
14696,1,1,487,1299,812
14697,1,1,242,1403,1161
14698,1,0,20,0,-20
14699,1,0,162,0,-162
14700,0,0,277,0,-277
14701,1,0,3,0,-3
14702,0,0,126,0,-126
14703,0,0,12,0,-12
14704,0,0,54,0,-54
14705,0,0,14,0,-14
14706,1,1,319,1499,1180
14707,1,1,326,1581,1255
14708,1,1,1111,1279,168
14709,0,0,84,0,-84
14710,0,0,30,0,-30
14711,1,0,15,0,-15
14712,0,0,37,0,-37
14713,1,1,723,1275,552
14714,1,0,14,0,-14
14715,1,0,59,0,-59
14716,1,0,1,0,-1
14717,1,1,291,1537,1246
14718,0,0,14,0,-14
14719,1,1,452,1242,790
14720,1,0,7,0,-7
14721,0,0,33,0,-33
14722,1,1,494,1461,967
14723,1,1,113,1490,1377
14724,1,0,3,0,-3
14725,0,0,58,0,-58
14726,0,0,268,0,-268
14727,0,0,41,0,-41
14728,1,1,284,1254,970
14729,1,1,116,1415,1299
14730,1,1,1011,1235,224
14731,0,0,96,0,-96
14732,1,0,0,0,0
14733,1,1,730,1297,567
14734,0,0,56,0,-56
14735,0,0,26,0,-26
14736,1,0,8,0,-8
14737,1,1,85,2195,2110
14738,0,0,43,0,-43
14739,1,1,2362,1525,-837
14740,1,0,39,0,-39
14741,1,0,10,0,-10
14742,1,1,1247,1530,283
14743,0,0,137,0,-137
14744,1,1,181,1217,1036
14745,1,0,6,0,-6
14746,0,0,46,0,-46
14747,1,0,86,0,-86
14748,0,0,16,0,-16
14749,0,0,50,0,-50
14750,0,0,56,0,-56
14751,1,1,852,3191,2339
14752,1,1,413,1228,815
14753,1,0,32,0,-32
14754,1,1,766,1376,610
14755,1,0,21,0,-21
14756,0,0,41,0,-41
14757,1,1,146,1496,1350
14758,0,0,83,0,-83
14759,1,1,300,1656,1356
14760,1,1,725,1758,1033
14761,1,0,53,0,-53
14762,0,0,143,0,-143
14763,1,1,316,1463,1147
14764,1,1,164,1314,1150
14765,0,0,20,0,-20
14766,0,0,14,0,-14
14767,1,1,159,1474,1315
14768,1,0,4,0,-4
14769,1,0,74,0,-74
14770,0,0,58,0,-58
14771,1,0,8,0,-8
14772,0,0,0,0,0
14773,0,0,63,0,-63
14774,1,1,243,1261,1018
14775,0,0,75,0,-75
14776,1,1,394,1331,937
14777,0,0,58,0,-58
14778,1,1,741,1423,682
14779,1,1,126,1576,1450
14780,1,0,25,0,-25
14781,1,1,199,1201,1002
14782,1,0,118,0,-118
14783,1,1,303,1410,1107
14784,0,0,26,0,-26
14785,1,1,323,1614,1291
14786,0,0,3,0,-3
14787,0,0,163,0,-163
14788,0,0,9,0,-9
14789,1,1,341,2953,2612
14790,0,0,14,0,-14
14791,1,1,117,2345,2228
14792,0,0,26,0,-26
14793,1,1,541,1234,693
14794,0,0,55,0,-55
14795,0,0,32,0,-32
14796,1,0,11,0,-11
14797,0,0,134,0,-134
14798,1,1,658,1888,1230
14799,0,0,16,0,-16
14800,1,0,129,0,-129
14801,0,0,129,0,-129
14802,0,0,20,0,-20
14803,0,0,17,0,-17
14804,0,0,58,0,-58
14805,0,0,2,0,-2
14806,0,0,12,0,-12
14807,1,0,117,0,-117
14808,1,0,48,0,-48
14809,0,0,200,0,-200
14810,1,1,683,1263,580
14811,1,1,712,1482,770
14812,0,0,17,0,-17
14813,0,0,8,0,-8
14814,1,1,734,1202,468
14815,1,1,272,2419,2147
14816,1,0,74,0,-74
14817,1,1,549,1226,677
14818,1,1,334,1340,1006
14819,0,0,23,0,-23
14820,0,0,80,0,-80
14821,0,0,7,0,-7
14822,0,0,95,0,-95
14823,0,0,70,0,-70
14824,0,0,31,0,-31
14825,1,0,25,0,-25
14826,1,0,48,0,-48
14827,1,0,61,0,-61
14828,1,0,56,0,-56
14829,1,1,446,1811,1365
14830,0,0,97,0,-97
14831,1,1,748,1354,606
14832,1,1,1315,1218,-97
14833,0,0,40,0,-40
14834,1,0,145,0,-145
14835,0,0,33,0,-33
14836,1,0,28,0,-28
14837,1,1,156,1342,1186
14838,1,1,105,1598,1493
14839,1,1,641,2012,1371
14840,0,0,4,0,-4
14841,1,0,9,0,-9
14842,1,0,38,0,-38
14843,1,1,157,1411,1254
14844,0,0,107,0,-107
14845,0,0,101,0,-101
14846,1,1,180,1200,1020
14847,1,0,1,0,-1
14848,0,0,106,0,-106
14849,1,0,71,0,-71
14850,0,0,22,0,-22
14851,0,0,51,0,-51
14852,0,0,90,0,-90
14853,1,0,35,0,-35
14854,1,0,67,0,-67
14855,1,1,185,1227,1042
14856,0,0,56,0,-56
14857,1,1,133,1334,1201
14858,1,0,39,0,-39
14859,0,0,25,0,-25
14860,0,0,95,0,-95
14861,1,1,207,2224,2017
14862,1,1,1304,1309,5
14863,1,1,628,2082,1454
14864,1,0,19,0,-19
14865,0,0,65,0,-65
14866,0,0,6,0,-6
14867,1,0,30,0,-30
14868,1,1,176,1271,1095
14869,0,0,3,0,-3
14870,1,0,30,0,-30
14871,0,0,37,0,-37
14872,1,0,6,0,-6
14873,1,0,72,0,-72
14874,1,1,59,1311,1252
14875,0,0,61,0,-61
14876,0,0,31,0,-31
14877,1,1,76,1401,1325
14878,0,0,107,0,-107
14879,1,1,1378,1824,446
14880,1,1,580,1275,695
14881,0,0,50,0,-50
14882,1,0,75,0,-75
14883,0,0,11,0,-11
14884,1,1,655,2848,2193
14885,0,0,11,0,-11
14886,0,0,46,0,-46
14887,1,0,62,0,-62
14888,0,0,8,0,-8
14889,0,0,135,0,-135
14890,1,1,220,1415,1195
14891,1,1,68,1474,1406
14892,1,0,160,0,-160
14893,0,0,27,0,-27
14894,0,0,171,0,-171
14895,1,1,9,1332,1323
14896,1,0,53,0,-53
14897,1,0,59,0,-59
14898,1,0,53,0,-53
14899,0,0,103,0,-103
14900,1,1,447,1226,779
14901,0,0,10,0,-10
14902,1,0,26,0,-26
14903,0,0,29,0,-29
14904,0,0,27,0,-27
14905,1,0,23,0,-23
14906,0,0,18,0,-18
14907,0,0,54,0,-54
14908,1,1,382,1313,931
14909,1,0,5,0,-5
14910,0,0,72,0,-72
14911,0,0,18,0,-18
14912,0,0,8,0,-8
14913,0,0,64,0,-64
14914,1,0,121,0,-121
14915,0,0,61,0,-61
14916,1,0,109,0,-109
14917,1,1,146,1835,1689
14918,1,1,190,1875,1685
14919,0,0,36,0,-36
14920,0,0,0,0,0
14921,1,0,15,0,-15
14922,1,1,589,1783,1194
14923,1,1,522,1441,919
14924,0,0,34,0,-34
14925,1,1,543,1713,1170
14926,0,0,21,0,-21
14927,1,0,155,0,-155
14928,1,0,20,0,-20
14929,0,0,42,0,-42
14930,1,1,148,1223,1075
14931,0,0,8,0,-8
14932,1,0,49,0,-49
14933,0,0,9,0,-9
14934,0,0,38,0,-38
14935,0,0,47,0,-47
14936,1,1,113,1650,1537
14937,0,0,9,0,-9
14938,0,0,73,0,-73
14939,0,0,76,0,-76
14940,1,1,172,2557,2385
14941,1,0,4,0,-4
14942,0,0,62,0,-62
14943,1,1,812,1803,991
14944,1,1,438,1295,857
14945,1,0,2,0,-2
14946,0,0,17,0,-17
14947,1,1,29,2156,2127
14948,1,1,69,1924,1855
14949,1,1,1672,1532,-140
14950,0,0,3,0,-3
14951,1,0,114,0,-114
14952,0,0,25,0,-25
14953,1,0,44,0,-44
14954,1,1,177,2129,1952
14955,1,1,659,1242,583
14956,0,0,85,0,-85
14957,0,0,15,0,-15
14958,1,1,377,1425,1048
14959,1,1,417,1723,1306
14960,0,0,4,0,-4
14961,1,1,496,1287,791
14962,1,0,37,0,-37
14963,0,0,42,0,-42
14964,1,0,121,0,-121
14965,1,1,1799,1430,-369
14966,1,1,314,1420,1106
14967,0,0,17,0,-17
14968,0,0,14,0,-14
14969,0,0,61,0,-61
14970,0,0,12,0,-12
14971,0,0,14,0,-14
14972,0,0,157,0,-157
14973,0,0,105,0,-105
14974,0,0,69,0,-69
14975,0,0,162,0,-162
14976,0,0,54,0,-54
14977,0,0,46,0,-46
14978,1,0,49,0,-49
14979,1,0,33,0,-33
14980,0,0,99,0,-99
14981,1,0,158,0,-158
14982,1,1,342,2242,1900
14983,1,0,17,0,-17
14984,0,0,30,0,-30
14985,1,0,38,0,-38
14986,1,0,121,0,-121
14987,1,0,0,0,0
14988,1,0,41,0,-41
14989,1,1,440,1271,831
14990,0,0,94,0,-94
14991,0,0,8,0,-8
14992,0,0,25,0,-25
14993,0,0,32,0,-32
14994,0,0,106,0,-106
14995,1,1,861,1283,422
14996,0,0,106,0,-106
14997,1,1,831,1707,876
14998,1,1,377,2554,2177
14999,1,1,760,1218,458
15000,0,0,115,0,-115
15001,1,1,529,1364,835
15002,0,0,25,0,-25
15003,1,0,5,0,-5
15004,0,0,169,0,-169
15005,0,0,82,0,-82
15006,1,0,27,0,-27
15007,1,1,193,1217,1024
15008,0,0,24,0,-24
15009,1,1,136,1291,1155
15010,1,1,229,1777,1548
15011,1,0,21,0,-21
15012,1,0,17,0,-17
15013,1,0,83,0,-83
15014,1,1,1619,1269,-350
15015,1,1,669,1817,1148
15016,1,0,45,0,-45
15017,0,0,33,0,-33
15018,1,0,3,0,-3
15019,0,0,8,0,-8
15020,1,0,20,0,-20
15021,0,0,47,0,-47
15022,1,0,40,0,-40
15023,1,0,109,0,-109
15024,0,0,11,0,-11
15025,1,0,89,0,-89
15026,1,1,211,1661,1450
15027,0,0,0,0,0
15028,0,0,18,0,-18
15029,0,0,52,0,-52
15030,1,0,30,0,-30
15031,0,0,187,0,-187
15032,1,1,312,1670,1358
15033,1,0,34,0,-34
15034,1,0,0,0,0
15035,1,1,561,1424,863
15036,0,0,106,0,-106
15037,0,0,210,0,-210
15038,1,0,47,0,-47
15039,1,0,80,0,-80
15040,0,0,12,0,-12
15041,1,0,112,0,-112
15042,0,0,34,0,-34
15043,1,0,8,0,-8
15044,1,0,111,0,-111
15045,1,0,17,0,-17
15046,1,1,1034,1685,651
15047,0,0,152,0,-152
15048,1,1,1510,1531,21
15049,1,0,40,0,-40
15050,1,1,167,1505,1338
15051,1,1,754,1380,626
15052,1,1,1495,1239,-256
15053,0,0,28,0,-28
15054,1,1,365,1492,1127
15055,1,0,13,0,-13
15056,0,0,19,0,-19
15057,0,0,199,0,-199
15058,1,0,21,0,-21
15059,1,1,75,1262,1187
15060,0,0,46,0,-46
15061,1,1,920,1698,778
15062,0,0,6,0,-6
15063,1,1,142,2026,1884
15064,0,0,9,0,-9
15065,1,0,4,0,-4
15066,0,0,116,0,-116
15067,0,0,38,0,-38
15068,1,1,858,1295,437
15069,1,0,73,0,-73
15070,1,0,86,0,-86
15071,1,0,73,0,-73
15072,1,0,46,0,-46
15073,1,0,64,0,-64
15074,1,1,347,1235,888
15075,1,1,735,1253,518
15076,0,0,1,0,-1
15077,0,0,82,0,-82
15078,0,0,7,0,-7
15079,1,1,398,1926,1528
15080,1,0,25,0,-25
15081,0,0,38,0,-38
15082,1,1,232,1626,1394
15083,1,1,742,2281,1539
15084,0,0,88,0,-88
15085,1,0,15,0,-15
15086,0,0,110,0,-110
15087,1,1,103,1391,1288
15088,0,0,81,0,-81
15089,1,1,278,1341,1063
15090,0,0,93,0,-93
15091,1,0,95,0,-95
15092,0,0,52,0,-52
15093,0,0,11,0,-11
15094,1,1,236,1344,1108
15095,0,0,15,0,-15
15096,0,0,5,0,-5
15097,1,0,63,0,-63
15098,1,1,1168,1262,94
15099,0,0,0,0,0
15100,1,1,1475,1690,215
15101,1,0,36,0,-36
15102,0,0,31,0,-31
15103,1,0,40,0,-40
15104,0,0,127,0,-127
15105,1,1,65,1554,1489
15106,1,1,118,2039,1921
15107,0,0,32,0,-32
15108,1,0,72,0,-72
15109,1,1,1063,1460,397
15110,1,0,24,0,-24
15111,0,0,13,0,-13
15112,0,0,6,0,-6
15113,1,0,174,0,-174
15114,1,1,441,1202,761
15115,0,0,19,0,-19
15116,0,0,26,0,-26
15117,0,0,3,0,-3
15118,0,0,174,0,-174
15119,1,0,37,0,-37
15120,1,0,23,0,-23
15121,1,0,105,0,-105
15122,0,0,26,0,-26
15123,1,1,1571,1823,252
15124,1,1,339,1822,1483
15125,1,1,55,1389,1334
15126,0,0,167,0,-167
15127,1,0,1,0,-1
15128,1,0,77,0,-77
15129,0,0,29,0,-29
15130,0,0,62,0,-62
15131,0,0,41,0,-41
15132,0,0,43,0,-43
15133,0,0,67,0,-67
15134,0,0,127,0,-127
15135,0,0,4,0,-4
15136,0,0,133,0,-133
15137,0,0,12,0,-12
15138,0,0,8,0,-8
15139,0,0,4,0,-4
15140,1,1,478,3416,2938
15141,0,0,54,0,-54
15142,1,1,748,1571,823
15143,1,1,789,1494,705
15144,1,1,213,1239,1026
15145,1,0,32,0,-32
15146,1,1,1319,1898,579
15147,1,0,5,0,-5
15148,0,0,1,0,-1
15149,1,0,60,0,-60
15150,1,1,1007,1915,908
15151,0,0,0,0,0
15152,0,0,12,0,-12
15153,0,0,112,0,-112
15154,0,0,0,0,0
15155,1,1,393,1385,992
15156,1,1,1503,1454,-49
15157,0,0,69,0,-69
15158,1,1,883,1332,449
15159,1,0,8,0,-8
15160,1,0,84,0,-84
15161,0,0,56,0,-56
15162,0,0,5,0,-5
15163,1,1,512,1222,710
15164,1,0,6,0,-6
15165,1,1,326,1340,1014
15166,1,1,473,1788,1315
15167,1,0,50,0,-50
15168,1,1,527,3429,2902
15169,1,0,58,0,-58
15170,0,0,12,0,-12
15171,0,0,48,0,-48
15172,1,1,812,1261,449
15173,1,1,472,1328,856
15174,0,0,82,0,-82
15175,0,0,172,0,-172
15176,1,0,76,0,-76
15177,1,1,1278,1571,293
15178,0,0,49,0,-49
15179,1,0,88,0,-88
15180,1,1,290,1217,927
15181,0,0,0,0,0
15182,0,0,42,0,-42
15183,0,0,18,0,-18
15184,1,1,370,1514,1144
15185,1,1,733,1528,795
15186,0,0,91,0,-91
15187,1,1,897,1385,488
15188,1,0,81,0,-81
15189,0,0,77,0,-77
15190,1,0,47,0,-47
15191,0,0,117,0,-117
15192,1,1,1584,1273,-311
15193,1,0,44,0,-44
15194,0,0,5,0,-5
15195,0,0,18,0,-18
15196,0,0,27,0,-27
15197,1,1,214,1338,1124
15198,0,0,7,0,-7
15199,1,0,4,0,-4
15200,0,0,146,0,-146
15201,1,1,1444,1379,-65
15202,1,1,752,1319,567
15203,1,1,307,1507,1200
15204,1,0,53,0,-53
15205,0,0,15,0,-15
15206,0,0,7,0,-7
15207,1,1,329,1412,1083
15208,1,0,85,0,-85
15209,1,1,92,2435,2343
15210,1,0,245,0,-245
15211,1,0,3,0,-3
15212,1,0,127,0,-127
15213,0,0,41,0,-41
15214,1,1,1774,2543,769
15215,0,0,3,0,-3
15216,1,1,1729,1390,-339
15217,1,0,43,0,-43
15218,0,0,45,0,-45
15219,1,0,29,0,-29
15220,0,0,36,0,-36
15221,1,1,330,1449,1119
15222,0,0,70,0,-70
15223,1,0,54,0,-54
15224,1,0,10,0,-10
15225,0,0,4,0,-4
15226,0,0,28,0,-28
15227,1,0,26,0,-26
15228,1,0,119,0,-119
15229,1,0,9,0,-9
15230,0,0,96,0,-96
15231,0,0,82,0,-82
15232,0,0,23,0,-23
15233,1,0,3,0,-3
15234,0,0,108,0,-108
15235,1,0,12,0,-12
15236,1,1,637,1315,678
15237,0,0,117,0,-117
15238,0,0,27,0,-27
15239,1,0,78,0,-78
15240,1,1,168,1878,1710
15241,1,1,1308,1756,448
15242,0,0,32,0,-32
15243,1,1,1244,1249,5
15244,0,0,0,0,0
15245,0,0,51,0,-51
15246,1,0,127,0,-127
15247,0,0,22,0,-22
15248,1,0,194,0,-194
15249,0,0,10,0,-10
15250,0,0,15,0,-15
15251,0,0,8,0,-8
15252,0,0,222,0,-222
15253,0,0,110,0,-110
15254,0,0,11,0,-11
15255,1,0,6,0,-6
15256,1,1,372,1763,1391
15257,1,1,37,1315,1278
15258,1,1,220,2211,1991
15259,0,0,93,0,-93
15260,0,0,25,0,-25
15261,0,0,40,0,-40
15262,1,1,1104,1423,319
15263,0,0,64,0,-64
15264,0,0,99,0,-99
15265,0,0,73,0,-73
15266,0,0,52,0,-52
15267,1,0,19,0,-19
15268,1,0,30,0,-30
15269,1,0,9,0,-9
15270,1,1,403,1542,1139
15271,0,0,8,0,-8
15272,0,0,67,0,-67
15273,0,0,163,0,-163
15274,1,0,22,0,-22
15275,1,0,32,0,-32
15276,0,0,1,0,-1
15277,1,0,7,0,-7
15278,0,0,38,0,-38
15279,0,0,197,0,-197
15280,1,1,147,1827,1680
15281,1,0,34,0,-34
15282,0,0,5,0,-5
15283,0,0,67,0,-67
15284,1,1,455,1448,993
15285,1,1,1098,1393,295
15286,0,0,13,0,-13
15287,1,0,28,0,-28
15288,0,0,68,0,-68
15289,0,0,28,0,-28
15290,0,0,56,0,-56
15291,1,1,384,1576,1192
15292,1,1,182,1938,1756
15293,0,0,98,0,-98
15294,1,1,1023,1671,648
15295,0,0,29,0,-29
15296,1,0,70,0,-70
15297,1,0,78,0,-78
15298,1,1,382,1284,902
15299,1,1,1112,1496,384
15300,0,0,33,0,-33
15301,1,1,182,1256,1074
15302,1,1,391,1386,995
15303,0,0,102,0,-102
15304,1,1,169,1455,1286
15305,0,0,61,0,-61
15306,1,0,48,0,-48
15307,0,0,11,0,-11
15308,1,0,90,0,-90
15309,0,0,117,0,-117
15310,0,0,71,0,-71
15311,1,1,1891,1247,-644
15312,1,0,78,0,-78
15313,1,0,74,0,-74
15314,0,0,35,0,-35
15315,1,0,3,0,-3
15316,0,0,29,0,-29
15317,0,0,100,0,-100
15318,0,0,134,0,-134
15319,1,0,30,0,-30
15320,0,0,32,0,-32
15321,1,1,1862,1273,-589
15322,1,0,25,0,-25
15323,1,1,566,1212,646
15324,0,0,20,0,-20
15325,1,0,34,0,-34
15326,0,0,248,0,-248
15327,1,0,15,0,-15
15328,0,0,24,0,-24
15329,0,0,4,0,-4
15330,0,0,82,0,-82
15331,1,0,105,0,-105
15332,1,1,57,1271,1214
15333,0,0,76,0,-76
15334,1,0,21,0,-21
15335,1,0,5,0,-5
15336,1,0,140,0,-140
15337,1,1,177,1536,1359
15338,0,0,6,0,-6
15339,0,0,13,0,-13
15340,0,0,46,0,-46
15341,1,0,5,0,-5
15342,1,0,64,0,-64
15343,1,0,34,0,-34
15344,0,0,52,0,-52
15345,0,0,89,0,-89
15346,1,1,176,1947,1771
15347,1,1,769,1217,448
15348,0,0,0,0,0
15349,1,1,30,1329,1299
15350,1,0,63,0,-63
15351,1,0,22,0,-22
15352,1,0,49,0,-49
15353,0,0,25,0,-25
15354,1,1,576,2308,1732
15355,0,0,200,0,-200
15356,1,0,55,0,-55
15357,0,0,47,0,-47
15358,1,1,85,1503,1418
15359,0,0,36,0,-36
15360,1,0,74,0,-74
15361,0,0,72,0,-72
15362,0,0,54,0,-54
15363,0,0,30,0,-30
15364,0,0,11,0,-11
15365,1,1,156,1486,1330
15366,0,0,3,0,-3
15367,1,0,25,0,-25
15368,0,0,18,0,-18
15369,1,0,33,0,-33
15370,1,1,308,2078,1770
15371,1,0,108,0,-108
15372,1,0,39,0,-39
15373,1,1,568,2143,1575
15374,0,0,135,0,-135
15375,1,0,4,0,-4
15376,0,0,58,0,-58
15377,1,1,239,1561,1322
15378,0,0,56,0,-56
15379,1,1,95,1422,1327
15380,1,0,36,0,-36
15381,0,0,16,0,-16
15382,1,0,69,0,-69
15383,1,1,1342,1225,-117
15384,0,0,48,0,-48
15385,1,0,2,0,-2
15386,0,0,62,0,-62
15387,1,0,9,0,-9
15388,0,0,44,0,-44
15389,1,0,10,0,-10
15390,0,0,105,0,-105
15391,0,0,2,0,-2
15392,1,0,115,0,-115
15393,1,0,78,0,-78
15394,1,1,112,1303,1191
15395,0,0,7,0,-7
15396,1,0,3,0,-3
15397,1,1,228,1344,1116
15398,1,0,34,0,-34
15399,1,1,1074,1895,821
15400,0,0,66,0,-66
15401,1,0,1,0,-1
15402,0,0,2,0,-2
15403,1,1,126,2223,2097
15404,1,0,27,0,-27
15405,1,0,189,0,-189
15406,1,1,230,2371,2141
15407,0,0,66,0,-66
15408,1,0,163,0,-163
15409,0,0,34,0,-34
15410,1,0,61,0,-61
15411,0,0,40,0,-40
15412,0,0,116,0,-116
15413,1,1,210,1797,1587
15414,1,1,1117,1277,160
15415,0,0,147,0,-147
15416,1,0,51,0,-51
15417,0,0,4,0,-4
15418,0,0,10,0,-10
15419,0,0,55,0,-55
15420,1,0,5,0,-5
15421,1,0,61,0,-61
15422,1,0,19,0,-19
15423,1,0,56,0,-56
15424,1,1,1165,2784,1619
15425,1,0,63,0,-63
15426,1,1,328,1255,927
15427,1,1,166,3085,2919
15428,0,0,53,0,-53
15429,0,0,77,0,-77
15430,0,0,5,0,-5
15431,1,0,57,0,-57
15432,1,1,118,1455,1337
15433,0,0,191,0,-191
15434,1,1,1076,1318,242
15435,0,0,58,0,-58
15436,1,1,569,1280,711
15437,1,0,213,0,-213
15438,1,0,8,0,-8
15439,1,1,468,1207,739
15440,1,0,5,0,-5
15441,0,0,25,0,-25
15442,1,0,11,0,-11
15443,0,0,15,0,-15
15444,0,0,16,0,-16
15445,1,0,188,0,-188
15446,1,0,107,0,-107
15447,1,0,36,0,-36
15448,1,0,42,0,-42
15449,1,0,0,0,0
15450,1,0,51,0,-51
15451,0,0,29,0,-29
15452,1,1,1760,1286,-474
15453,1,1,149,1352,1203
15454,0,0,48,0,-48
15455,0,0,30,0,-30
15456,1,1,243,1930,1687
15457,0,0,300,0,-300
15458,1,1,352,1360,1008
15459,1,0,36,0,-36
15460,0,0,6,0,-6
15461,1,0,4,0,-4
15462,0,0,18,0,-18
15463,1,1,694,1402,708
15464,0,0,27,0,-27
15465,1,1,183,1365,1182
15466,1,1,771,1670,899
15467,0,0,16,0,-16
15468,1,1,109,1237,1128
15469,1,0,58,0,-58
15470,0,0,43,0,-43
15471,1,0,26,0,-26
15472,1,0,156,0,-156
15473,0,0,39,0,-39
15474,0,0,18,0,-18
15475,1,1,576,1427,851
15476,0,0,10,0,-10
15477,1,0,11,0,-11
15478,1,0,14,0,-14
15479,0,0,13,0,-13
15480,0,0,24,0,-24
15481,0,0,31,0,-31
15482,1,0,86,0,-86
15483,1,1,805,1583,778
15484,1,0,51,0,-51
15485,0,0,43,0,-43
15486,1,1,156,1830,1674
15487,1,0,105,0,-105
15488,0,0,31,0,-31
15489,1,1,319,1380,1061
15490,1,1,187,1252,1065
15491,1,1,1899,1457,-442
15492,1,0,223,0,-223
15493,1,0,6,0,-6
15494,1,1,212,1665,1453
15495,1,0,172,0,-172
15496,0,0,17,0,-17
15497,0,0,101,0,-101
15498,0,0,44,0,-44
15499,1,0,39,0,-39
15500,1,0,21,0,-21
15501,0,0,87,0,-87
15502,1,1,729,1772,1043
15503,0,0,144,0,-144
15504,1,1,171,2527,2356
15505,1,1,243,1283,1040
15506,1,1,360,1332,972
15507,1,1,120,1284,1164
15508,0,0,91,0,-91
15509,1,1,291,1392,1101
15510,1,0,15,0,-15
15511,1,1,34,1563,1529
15512,1,1,610,1620,1010
15513,1,1,336,2079,1743
15514,1,0,140,0,-140
15515,0,0,74,0,-74
15516,0,0,146,0,-146
15517,0,0,17,0,-17
15518,1,0,21,0,-21
15519,1,1,101,1419,1318
15520,0,0,31,0,-31
15521,0,0,38,0,-38
15522,0,0,33,0,-33
15523,0,0,13,0,-13
15524,1,0,2,0,-2
15525,0,0,11,0,-11
15526,1,0,3,0,-3
15527,0,0,55,0,-55
15528,0,0,40,0,-40
15529,0,0,5,0,-5
15530,0,0,0,0,0
15531,1,1,305,1334,1029
15532,1,1,131,3888,3757
15533,0,0,15,0,-15
15534,1,0,0,0,0
15535,1,1,629,1637,1008
15536,1,1,43,2129,2086
15537,0,0,38,0,-38
15538,0,0,85,0,-85
15539,1,1,53,1334,1281
15540,0,0,54,0,-54
15541,0,0,31,0,-31
15542,1,1,583,1663,1080
15543,1,0,10,0,-10
15544,1,0,52,0,-52
15545,1,0,73,0,-73
15546,0,0,2,0,-2
15547,0,0,29,0,-29
15548,0,0,114,0,-114
15549,1,0,22,0,-22
15550,1,1,360,1320,960
15551,1,0,19,0,-19
15552,1,1,548,2199,1651
15553,1,1,197,1208,1011
15554,1,0,8,0,-8
15555,1,1,1861,1625,-236
15556,1,1,1338,1249,-89
15557,1,0,49,0,-49
15558,1,1,429,1204,775
15559,0,0,85,0,-85
15560,0,0,25,0,-25
15561,0,0,95,0,-95
15562,0,0,60,0,-60
15563,0,0,10,0,-10
15564,1,0,19,0,-19
15565,0,0,15,0,-15
15566,1,1,598,2057,1459
15567,1,1,1349,1428,79
15568,0,0,148,0,-148
15569,1,0,68,0,-68
15570,0,0,21,0,-21
15571,0,0,28,0,-28
15572,1,0,111,0,-111
15573,1,1,891,1404,513
15574,0,0,42,0,-42
15575,0,0,4,0,-4
15576,1,1,542,1387,845
15577,1,1,283,2081,1798
15578,1,0,18,0,-18
15579,1,1,1414,1447,33
15580,1,1,248,1321,1073
15581,1,1,1094,1294,200
15582,0,0,10,0,-10
15583,0,0,61,0,-61
15584,0,0,4,0,-4
15585,1,1,155,1495,1340
15586,0,0,32,0,-32
15587,1,1,876,1518,642
15588,1,1,77,2205,2128
15589,1,1,148,1473,1325
15590,0,0,12,0,-12
15591,0,0,2,0,-2
15592,1,0,76,0,-76
15593,0,0,29,0,-29
15594,1,1,665,1530,865
15595,1,0,60,0,-60
15596,0,0,144,0,-144
15597,0,0,45,0,-45
15598,1,1,170,1381,1211
15599,0,0,9,0,-9
15600,0,0,36,0,-36
15601,1,1,534,1351,817
15602,1,0,2,0,-2
15603,1,1,1099,1595,496
15604,0,0,21,0,-21
15605,0,0,5,0,-5
15606,1,1,153,1228,1075
15607,0,0,282,0,-282
15608,1,0,88,0,-88
15609,1,0,43,0,-43
15610,1,0,21,0,-21
15611,1,0,7,0,-7
15612,1,0,6,0,-6
15613,1,0,27,0,-27
15614,1,0,13,0,-13
15615,0,0,53,0,-53
15616,1,0,69,0,-69
15617,1,1,420,1593,1173
15618,0,0,108,0,-108
15619,0,0,53,0,-53
15620,0,0,33,0,-33
15621,0,0,45,0,-45
15622,1,0,111,0,-111
15623,0,0,212,0,-212
15624,0,0,83,0,-83
15625,0,0,2,0,-2
15626,1,1,134,1868,1734
15627,0,0,17,0,-17
15628,1,0,39,0,-39
15629,1,0,11,0,-11
15630,1,1,701,1318,617
15631,1,1,111,1780,1669
15632,1,0,11,0,-11
15633,0,0,8,0,-8
15634,0,0,14,0,-14
15635,1,0,15,0,-15
15636,1,0,17,0,-17
15637,0,0,33,0,-33
15638,1,1,961,1384,423
15639,0,0,24,0,-24
15640,1,0,1,0,-1
15641,1,0,34,0,-34
15642,1,0,15,0,-15
15643,0,0,26,0,-26
15644,0,0,5,0,-5
15645,1,1,120,1670,1550
15646,1,0,18,0,-18
15647,1,1,1241,1252,11
15648,1,1,762,1619,857
15649,1,0,32,0,-32
15650,1,0,14,0,-14
15651,1,1,5,1267,1262
15652,1,1,72,1349,1277
15653,1,1,496,2164,1668
15654,1,1,494,1646,1152
15655,1,1,330,2844,2514
15656,0,0,9,0,-9
15657,0,0,50,0,-50
15658,0,0,2,0,-2
15659,1,1,99,2046,1947
15660,1,1,912,1256,344
15661,1,1,95,2041,1946
15662,0,0,16,0,-16
15663,1,1,400,1215,815
15664,1,1,572,1582,1010
15665,0,0,22,0,-22
15666,0,0,49,0,-49
15667,1,0,109,0,-109
15668,1,1,767,2228,1461
15669,0,0,7,0,-7
15670,1,1,95,1655,1560
15671,1,1,465,1726,1261
15672,1,0,20,0,-20
15673,1,0,26,0,-26
15674,1,1,554,2322,1768
15675,1,0,17,0,-17
15676,0,0,105,0,-105
15677,0,0,11,0,-11
15678,0,0,34,0,-34
15679,1,0,35,0,-35
15680,1,1,53,1248,1195
15681,1,0,0,0,0
15682,1,1,333,1233,900
15683,1,0,92,0,-92
15684,1,0,44,0,-44
15685,1,1,1029,3099,2070
15686,0,0,51,0,-51
15687,0,0,184,0,-184
15688,0,0,2,0,-2
15689,0,0,6,0,-6
15690,1,0,83,0,-83
15691,1,1,66,1211,1145
15692,0,0,43,0,-43
15693,1,1,264,1678,1414
15694,1,1,1837,1359,-478
15695,0,0,4,0,-4
15696,0,0,46,0,-46
15697,0,0,17,0,-17
15698,0,0,45,0,-45
15699,1,1,990,1219,229
15700,0,0,14,0,-14
15701,0,0,38,0,-38
15702,1,1,458,1362,904
15703,0,0,10,0,-10
15704,1,1,20,1292,1272
15705,0,0,44,0,-44
15706,1,1,116,1315,1199
15707,1,1,661,1407,746
15708,1,0,65,0,-65
15709,1,0,80,0,-80
15710,1,1,590,1421,831
15711,1,0,3,0,-3
15712,1,1,579,1594,1015
15713,1,1,883,2416,1533
15714,0,0,41,0,-41
15715,1,1,647,2493,1846
15716,0,0,12,0,-12
15717,1,1,454,2935,2481
15718,1,0,26,0,-26
15719,1,0,4,0,-4
15720,1,0,154,0,-154
15721,0,0,32,0,-32
15722,0,0,28,0,-28
15723,1,1,437,1457,1020
15724,1,1,342,1951,1609
15725,0,0,33,0,-33
15726,1,0,139,0,-139
15727,0,0,36,0,-36
15728,0,0,70,0,-70
15729,1,0,134,0,-134
15730,1,1,745,1315,570
15731,1,0,9,0,-9
15732,0,0,46,0,-46
15733,1,1,174,1423,1249
15734,0,0,11,0,-11
15735,0,0,93,0,-93
15736,1,0,105,0,-105
15737,0,0,34,0,-34
15738,1,0,230,0,-230
15739,1,1,400,1353,953
15740,1,1,346,1205,859
15741,0,0,186,0,-186
15742,0,0,144,0,-144
15743,1,1,63,1200,1137
15744,1,1,1248,1972,724
15745,1,0,19,0,-19
15746,1,0,47,0,-47
15747,1,1,652,1306,654
15748,1,1,258,1248,990
15749,0,0,37,0,-37
15750,1,1,810,1243,433
15751,1,0,111,0,-111
15752,1,0,48,0,-48
15753,1,0,17,0,-17
15754,1,0,45,0,-45
15755,1,0,14,0,-14
15756,1,0,36,0,-36
15757,0,0,21,0,-21
15758,0,0,17,0,-17
15759,1,1,992,1350,358
15760,0,0,92,0,-92
15761,0,0,51,0,-51
15762,1,0,74,0,-74
15763,1,0,150,0,-150
15764,0,0,0,0,0
15765,1,0,9,0,-9
15766,0,0,108,0,-108
15767,0,0,98,0,-98
15768,0,0,52,0,-52
15769,1,1,302,1538,1236
15770,1,1,158,1461,1303
15771,1,1,170,1465,1295
15772,1,0,39,0,-39
15773,1,1,257,1240,983
15774,0,0,7,0,-7
15775,0,0,64,0,-64
15776,1,0,37,0,-37
15777,0,0,3,0,-3
15778,1,0,4,0,-4
15779,1,0,80,0,-80
15780,1,1,100,1595,1495
15781,1,1,28,2191,2163
15782,1,1,2644,1544,-1100
15783,1,0,89,0,-89
15784,1,0,12,0,-12
15785,0,0,21,0,-21
15786,0,0,6,0,-6
15787,1,0,14,0,-14
15788,0,0,25,0,-25
15789,0,0,26,0,-26
15790,1,1,971,1272,301
15791,1,0,46,0,-46
15792,0,0,170,0,-170
15793,1,0,2,0,-2
15794,0,0,86,0,-86
15795,1,0,65,0,-65
15796,1,0,2,0,-2
15797,0,0,8,0,-8
15798,0,0,92,0,-92
15799,0,0,11,0,-11
15800,0,0,30,0,-30
15801,0,0,18,0,-18
15802,1,1,828,2689,1861
15803,0,0,17,0,-17
15804,1,0,36,0,-36
15805,1,0,49,0,-49
15806,1,0,68,0,-68
15807,1,0,13,0,-13
15808,1,0,109,0,-109
15809,1,0,9,0,-9
15810,0,0,23,0,-23
15811,0,0,60,0,-60
15812,1,0,30,0,-30
15813,0,0,142,0,-142
15814,1,0,119,0,-119
15815,0,0,32,0,-32
15816,1,1,1499,1349,-150
15817,1,1,272,1298,1026
15818,1,0,39,0,-39
15819,1,1,630,1271,641
15820,0,0,103,0,-103
15821,1,0,9,0,-9
15822,0,0,17,0,-17
15823,1,0,73,0,-73
15824,0,0,19,0,-19
15825,1,0,11,0,-11
15826,1,0,22,0,-22
15827,1,0,19,0,-19
15828,1,1,292,1518,1226
15829,0,0,38,0,-38
15830,1,1,279,1257,978
15831,0,0,98,0,-98
15832,1,0,3,0,-3
15833,1,1,655,1873,1218
15834,1,0,22,0,-22
15835,1,0,7,0,-7
15836,1,0,35,0,-35
15837,1,0,12,0,-12
15838,0,0,73,0,-73
15839,1,1,38,1279,1241
15840,1,1,891,1637,746
15841,1,1,438,1200,762
15842,1,0,73,0,-73
15843,0,0,34,0,-34
15844,1,1,631,1229,598
15845,0,0,23,0,-23
15846,1,1,1095,3096,2001
15847,0,0,65,0,-65
15848,1,1,559,1221,662
15849,1,0,15,0,-15
15850,0,0,164,0,-164
15851,1,0,3,0,-3
15852,1,1,237,1782,1545
15853,1,1,1381,2156,775
15854,0,0,115,0,-115
15855,1,1,710,1922,1212
15856,1,1,509,1222,713
15857,0,0,82,0,-82
15858,0,0,60,0,-60
15859,0,0,27,0,-27
15860,1,0,1,0,-1
15861,0,0,9,0,-9
15862,1,1,123,1844,1721
15863,1,1,1061,1731,670
15864,1,0,14,0,-14
15865,1,0,102,0,-102
15866,1,0,28,0,-28
15867,1,1,868,1331,463
15868,1,1,221,1247,1026
15869,1,1,183,4837,4654
15870,1,1,598,1255,657
15871,1,1,412,1617,1205
15872,1,1,138,1319,1181
15873,0,0,3,0,-3
15874,1,1,53,1635,1582
15875,0,0,55,0,-55
15876,1,0,56,0,-56
15877,0,0,40,0,-40
15878,1,0,55,0,-55
15879,1,0,51,0,-51
15880,1,0,33,0,-33
15881,1,0,29,0,-29
15882,1,0,22,0,-22
15883,0,0,15,0,-15
15884,1,1,180,1645,1465
15885,0,0,79,0,-79
15886,1,1,315,1229,914
15887,1,1,407,1890,1483
15888,1,1,305,1766,1461
15889,1,1,367,1263,896
15890,0,0,11,0,-11
15891,1,0,26,0,-26
15892,1,1,1275,1392,117
15893,0,0,42,0,-42
15894,1,1,344,1257,913
15895,1,0,122,0,-122
15896,0,0,48,0,-48
15897,0,0,38,0,-38
15898,0,0,8,0,-8
15899,0,0,86,0,-86
15900,0,0,81,0,-81
15901,0,0,39,0,-39
15902,0,0,68,0,-68
15903,0,0,8,0,-8
15904,0,0,126,0,-126
15905,1,0,145,0,-145
15906,1,0,147,0,-147
15907,1,0,16,0,-16
15908,1,0,104,0,-104
15909,1,1,1128,1781,653
15910,1,0,61,0,-61
15911,0,0,87,0,-87
15912,1,1,233,1928,1695
15913,1,0,39,0,-39
15914,0,0,5,0,-5
15915,1,1,186,1861,1675
15916,1,1,188,1538,1350
15917,1,0,12,0,-12
15918,1,0,74,0,-74
15919,0,0,96,0,-96
15920,0,0,28,0,-28
15921,1,1,405,1587,1182
15922,1,0,22,0,-22
15923,1,0,8,0,-8
15924,1,1,285,1283,998
15925,0,0,37,0,-37
15926,0,0,18,0,-18
15927,1,1,192,1701,1509
15928,0,0,5,0,-5
15929,0,0,1,0,-1
15930,1,1,1334,1389,55
15931,1,0,38,0,-38
15932,1,0,19,0,-19
15933,1,0,27,0,-27
15934,0,0,137,0,-137
15935,1,0,17,0,-17
15936,1,1,77,1288,1211
15937,1,1,490,1249,759
15938,1,0,9,0,-9
15939,0,0,10,0,-10
15940,0,0,41,0,-41
15941,1,0,13,0,-13
15942,1,1,100,2291,2191
15943,0,0,27,0,-27
15944,1,0,29,0,-29
15945,1,1,214,1845,1631
15946,0,0,8,0,-8
15947,1,0,47,0,-47
15948,1,0,30,0,-30
15949,1,0,36,0,-36
15950,1,0,10,0,-10
15951,0,0,43,0,-43
15952,0,0,79,0,-79
15953,0,0,144,0,-144
15954,1,0,4,0,-4
15955,1,0,56,0,-56
15956,1,0,120,0,-120
15957,1,1,693,4204,3511
15958,1,0,28,0,-28
15959,0,0,34,0,-34
15960,0,0,243,0,-243
15961,0,0,21,0,-21
15962,1,1,214,1491,1277
15963,0,0,43,0,-43
15964,0,0,5,0,-5
15965,0,0,79,0,-79
15966,1,1,1319,2153,834
15967,1,0,15,0,-15
15968,1,1,249,1574,1325
15969,0,0,8,0,-8
15970,1,0,128,0,-128
15971,1,0,169,0,-169
15972,1,0,71,0,-71
15973,1,0,51,0,-51
15974,1,0,40,0,-40
15975,1,0,3,0,-3
15976,1,0,9,0,-9
15977,1,0,49,0,-49
15978,1,0,19,0,-19
15979,1,0,2,0,-2
15980,1,1,150,1372,1222
15981,0,0,8,0,-8
15982,0,0,51,0,-51
15983,1,1,1735,1839,104
15984,1,1,1321,1232,-89
15985,0,0,9,0,-9
15986,0,0,39,0,-39
15987,1,0,43,0,-43
15988,0,0,24,0,-24
15989,1,1,909,1245,336
15990,0,0,15,0,-15
15991,0,0,110,0,-110
15992,0,0,4,0,-4
15993,0,0,24,0,-24
15994,0,0,3,0,-3
15995,0,0,26,0,-26
15996,1,1,1794,1489,-305
15997,1,0,57,0,-57
15998,1,1,525,1702,1177
15999,1,1,273,1239,966
16000,0,0,5,0,-5
16001,1,1,300,1370,1070
16002,0,0,49,0,-49
16003,1,1,449,1423,974
16004,1,1,911,1358,447
16005,1,0,147,0,-147
16006,1,0,0,0,0
16007,0,0,79,0,-79
16008,1,0,13,0,-13
16009,0,0,53,0,-53
16010,1,0,3,0,-3
16011,1,0,35,0,-35
16012,1,0,91,0,-91
16013,0,0,19,0,-19
16014,0,0,18,0,-18
16015,1,1,368,1267,899
16016,0,0,9,0,-9
16017,1,0,23,0,-23
16018,1,0,88,0,-88
16019,0,0,112,0,-112
16020,1,0,69,0,-69
16021,0,0,30,0,-30
16022,0,0,8,0,-8
16023,0,0,86,0,-86
16024,1,1,185,1270,1085
16025,1,0,52,0,-52
16026,0,0,49,0,-49
16027,1,0,232,0,-232
16028,1,1,289,1309,1020
16029,1,0,13,0,-13
16030,0,0,122,0,-122
16031,0,0,46,0,-46
16032,1,1,250,1510,1260
16033,0,0,23,0,-23
16034,0,0,59,0,-59
16035,1,0,75,0,-75
16036,0,0,78,0,-78
16037,1,0,252,0,-252
16038,1,0,40,0,-40
16039,0,0,120,0,-120
16040,0,0,211,0,-211
16041,1,1,458,1222,764
16042,0,0,18,0,-18
16043,1,0,39,0,-39
16044,0,0,8,0,-8
16045,0,0,83,0,-83
16046,0,0,63,0,-63
16047,1,0,138,0,-138
16048,1,0,108,0,-108
16049,0,0,3,0,-3
16050,1,1,361,2728,2367
16051,0,0,3,0,-3
16052,1,0,0,0,0
16053,1,1,269,1573,1304
16054,1,1,157,1447,1290
16055,0,0,32,0,-32
16056,1,0,21,0,-21
16057,1,0,90,0,-90
16058,0,0,18,0,-18
16059,1,0,69,0,-69
16060,1,0,53,0,-53
16061,1,0,54,0,-54
16062,1,0,114,0,-114
16063,1,0,21,0,-21
16064,1,0,31,0,-31
16065,0,0,7,0,-7
16066,1,1,173,1710,1537
16067,0,0,19,0,-19
16068,1,0,34,0,-34
16069,1,1,482,1826,1344
16070,1,0,95,0,-95
16071,1,0,14,0,-14
16072,1,1,302,1487,1185
16073,0,0,99,0,-99
16074,1,1,465,2298,1833
16075,1,1,85,1839,1754
16076,0,0,53,0,-53
16077,0,0,14,0,-14
16078,1,0,15,0,-15
16079,1,1,177,1434,1257
16080,0,0,165,0,-165
16081,1,0,62,0,-62
16082,0,0,15,0,-15
16083,1,0,149,0,-149
16084,1,1,1309,1336,27
16085,1,0,84,0,-84
16086,0,0,150,0,-150
16087,1,0,34,0,-34
16088,1,1,173,1937,1764
16089,1,1,258,1203,945
16090,0,0,78,0,-78
16091,0,0,27,0,-27
16092,1,0,18,0,-18
16093,0,0,3,0,-3
16094,1,1,389,1905,1516
16095,1,1,274,2480,2206
16096,1,0,60,0,-60
16097,1,0,2,0,-2
16098,1,0,75,0,-75
16099,0,0,17,0,-17
16100,0,0,48,0,-48
16101,0,0,8,0,-8
16102,1,0,10,0,-10
16103,1,1,748,2006,1258
16104,0,0,61,0,-61
16105,1,1,647,1316,669
16106,0,0,84,0,-84
16107,1,1,102,1430,1328
16108,1,1,745,1257,512
16109,1,1,533,1316,783
16110,0,0,35,0,-35
16111,1,0,25,0,-25
16112,1,1,373,1260,887
16113,0,0,7,0,-7
16114,1,0,81,0,-81
16115,1,0,33,0,-33
16116,1,0,20,0,-20
16117,0,0,91,0,-91
16118,1,1,273,1738,1465
16119,0,0,70,0,-70
16120,1,0,18,0,-18
16121,1,0,8,0,-8
16122,1,0,12,0,-12
16123,1,0,49,0,-49
16124,1,0,79,0,-79
16125,1,0,20,0,-20
16126,0,0,111,0,-111
16127,1,1,312,1242,930
16128,0,0,59,0,-59
16129,1,1,313,1293,980
16130,1,1,376,1327,951
16131,1,0,4,0,-4
16132,0,0,83,0,-83
16133,1,0,45,0,-45
16134,0,0,34,0,-34
16135,0,0,9,0,-9
16136,1,0,1,0,-1
16137,1,1,448,1668,1220
16138,0,0,92,0,-92
16139,0,0,18,0,-18
16140,0,0,47,0,-47
16141,1,0,65,0,-65
16142,0,0,56,0,-56
16143,1,1,266,1364,1098
16144,1,1,135,1248,1113
16145,1,1,327,1235,908
16146,1,1,595,1297,702
16147,1,0,7,0,-7
16148,1,0,2,0,-2
16149,0,0,1,0,-1
16150,1,1,263,1497,1234
16151,0,0,56,0,-56
16152,1,0,37,0,-37
16153,0,0,99,0,-99
16154,1,0,75,0,-75
16155,1,1,572,1232,660
16156,1,0,60,0,-60
16157,0,0,24,0,-24
16158,0,0,1,0,-1
16159,1,1,766,1206,440
16160,1,1,955,1757,802
16161,0,0,98,0,-98
16162,1,1,312,1468,1156
16163,1,0,26,0,-26
16164,0,0,114,0,-114
16165,0,0,28,0,-28
16166,0,0,29,0,-29
16167,0,0,130,0,-130
16168,1,1,1760,1231,-529
16169,1,0,13,0,-13
16170,0,0,86,0,-86
16171,1,1,500,1389,889
16172,0,0,5,0,-5
16173,0,0,38,0,-38
16174,1,0,53,0,-53
16175,0,0,30,0,-30
16176,0,0,87,0,-87
16177,1,0,11,0,-11
16178,1,1,421,1322,901
16179,1,0,25,0,-25
16180,0,0,106,0,-106
16181,0,0,0,0,0
16182,1,1,940,1504,564
16183,0,0,107,0,-107
16184,1,1,591,1909,1318
16185,1,0,14,0,-14
16186,1,1,333,1434,1101
16187,1,0,1,0,-1
16188,1,1,652,1875,1223
16189,0,0,109,0,-109
16190,1,1,364,1200,836
16191,1,0,97,0,-97
16192,0,0,30,0,-30
16193,1,1,1390,1278,-112
16194,1,1,188,1353,1165
16195,1,0,24,0,-24
16196,1,1,46,1937,1891
16197,1,0,7,0,-7
16198,0,0,43,0,-43
16199,1,0,115,0,-115
16200,0,0,37,0,-37
16201,1,0,40,0,-40
16202,0,0,107,0,-107
16203,0,0,35,0,-35
16204,1,0,169,0,-169
16205,0,0,86,0,-86
16206,1,1,919,1245,326
16207,0,0,122,0,-122
16208,0,0,19,0,-19
16209,1,0,14,0,-14
16210,1,1,1215,1778,563
16211,1,0,17,0,-17
16212,1,1,138,1474,1336
16213,1,0,18,0,-18
16214,1,1,310,1398,1088
16215,1,0,66,0,-66
16216,1,1,64,1219,1155
16217,1,0,2,0,-2
16218,0,0,90,0,-90
16219,1,0,21,0,-21
16220,0,0,73,0,-73
16221,1,0,6,0,-6
16222,0,0,49,0,-49
16223,0,0,46,0,-46
16224,0,0,107,0,-107
16225,1,1,314,1378,1064
16226,1,0,109,0,-109
16227,1,0,27,0,-27
16228,1,0,187,0,-187
16229,0,0,100,0,-100
16230,0,0,46,0,-46
16231,1,1,522,1309,787
16232,1,1,943,1647,704
16233,0,0,14,0,-14
16234,1,0,27,0,-27
16235,1,1,1191,1317,126
16236,1,1,958,1360,402
16237,0,0,25,0,-25
16238,1,0,39,0,-39
16239,0,0,131,0,-131
16240,1,0,7,0,-7
16241,1,1,2056,1597,-459
16242,0,0,64,0,-64
16243,1,0,10,0,-10
16244,1,0,93,0,-93
16245,1,0,48,0,-48
16246,1,0,101,0,-101
16247,1,0,160,0,-160
16248,1,1,238,1245,1007
16249,1,0,15,0,-15
16250,1,0,16,0,-16
16251,1,1,338,1670,1332
16252,0,0,90,0,-90
16253,1,1,871,1333,462
16254,1,0,45,0,-45
16255,1,1,400,1463,1063
16256,1,1,302,1571,1269
16257,0,0,95,0,-95
16258,1,0,80,0,-80
16259,0,0,76,0,-76
16260,0,0,14,0,-14
16261,1,1,892,1557,665
16262,0,0,13,0,-13
16263,0,0,159,0,-159
16264,0,0,21,0,-21
16265,0,0,90,0,-90
16266,0,0,172,0,-172
16267,0,0,22,0,-22
16268,1,1,244,1380,1136
16269,1,0,30,0,-30
16270,1,0,101,0,-101
16271,0,0,34,0,-34
16272,0,0,72,0,-72
16273,0,0,68,0,-68
16274,0,0,67,0,-67
16275,1,1,922,2277,1355
16276,1,1,314,1451,1137
16277,1,1,377,1255,878
16278,1,1,852,1295,443
16279,0,0,40,0,-40
16280,0,0,19,0,-19
16281,0,0,29,0,-29
16282,0,0,39,0,-39
16283,1,0,9,0,-9
16284,0,0,5,0,-5
16285,1,0,8,0,-8
16286,1,0,65,0,-65
16287,1,1,191,1441,1250
16288,1,1,274,1390,1116
16289,1,1,654,1404,750
16290,1,1,74,1320,1246
16291,1,0,13,0,-13
16292,1,0,5,0,-5
16293,0,0,12,0,-12
16294,1,0,42,0,-42
16295,1,1,471,1223,752
16296,1,1,236,1410,1174
16297,1,0,178,0,-178
16298,1,1,1008,1564,556
16299,0,0,47,0,-47
16300,0,0,16,0,-16
16301,1,1,817,1511,694
16302,0,0,39,0,-39
16303,1,1,274,1262,988
16304,1,1,833,1332,499
16305,1,0,1,0,-1
16306,1,0,131,0,-131
16307,1,0,26,0,-26
16308,1,0,145,0,-145
16309,1,1,232,1225,993
16310,1,1,2897,2083,-814
16311,0,0,18,0,-18
16312,1,1,942,1620,678
16313,1,1,27,1207,1180
16314,1,0,124,0,-124
16315,1,1,465,1349,884
16316,0,0,49,0,-49
16317,1,1,641,2109,1468
16318,0,0,35,0,-35
16319,0,0,15,0,-15
16320,1,1,25,1231,1206
16321,0,0,152,0,-152
16322,1,1,603,1386,783
16323,0,0,48,0,-48
16324,0,0,49,0,-49
16325,1,0,24,0,-24
16326,1,0,17,0,-17
16327,0,0,6,0,-6
16328,0,0,30,0,-30
16329,1,0,22,0,-22
16330,1,0,48,0,-48
16331,0,0,14,0,-14
16332,0,0,10,0,-10
16333,0,0,6,0,-6
16334,1,1,118,1273,1155
16335,1,0,7,0,-7
16336,1,0,16,0,-16
16337,1,0,118,0,-118
16338,0,0,60,0,-60
16339,1,0,55,0,-55
16340,1,1,812,1534,722
16341,1,0,6,0,-6
16342,1,0,86,0,-86
16343,1,1,489,1454,965
16344,0,0,13,0,-13
16345,0,0,63,0,-63
16346,1,0,93,0,-93
16347,0,0,97,0,-97
16348,0,0,56,0,-56
16349,1,1,766,1211,445
16350,0,0,59,0,-59
16351,0,0,64,0,-64
16352,0,0,27,0,-27
16353,0,0,1,0,-1
16354,1,0,117,0,-117
16355,0,0,75,0,-75
16356,1,0,103,0,-103
16357,1,0,107,0,-107
16358,1,1,678,1574,896
16359,1,1,1246,3193,1947
16360,0,0,5,0,-5
16361,0,0,24,0,-24
16362,1,0,83,0,-83
16363,0,0,69,0,-69
16364,1,1,1082,1202,120
16365,1,0,8,0,-8
16366,1,0,6,0,-6
16367,1,1,169,1455,1286
16368,1,1,140,1453,1313
16369,1,1,905,1319,414
16370,0,0,5,0,-5
16371,1,0,61,0,-61
16372,1,1,105,1276,1171
16373,1,1,904,1331,427
16374,1,0,62,0,-62
16375,1,1,66,1324,1258
16376,1,0,60,0,-60
16377,1,1,1055,1242,187
16378,0,0,20,0,-20
16379,1,1,55,1439,1384
16380,1,0,134,0,-134
16381,0,0,77,0,-77
16382,1,1,418,1356,938
16383,1,1,170,2274,2104
16384,1,0,34,0,-34
16385,1,1,1023,1226,203
16386,1,0,26,0,-26
16387,1,1,115,1651,1536
16388,0,0,1,0,-1
16389,1,1,196,2372,2176
16390,1,1,1970,1251,-719
16391,0,0,54,0,-54
16392,0,0,134,0,-134
16393,1,0,57,0,-57
16394,0,0,22,0,-22
16395,0,0,28,0,-28
16396,1,1,915,2301,1386
16397,1,0,25,0,-25
16398,1,0,121,0,-121
16399,0,0,12,0,-12
16400,1,0,1,0,-1
16401,1,1,1439,1239,-200
16402,1,1,60,1608,1548
16403,1,0,6,0,-6
16404,1,1,621,2842,2221
16405,1,1,335,1260,925
16406,1,1,188,1652,1464
16407,1,0,20,0,-20
16408,1,1,452,1253,801
16409,1,0,64,0,-64
16410,0,0,7,0,-7
16411,1,0,26,0,-26
16412,0,0,21,0,-21
16413,0,0,98,0,-98
16414,1,0,175,0,-175
16415,1,0,73,0,-73
16416,0,0,201,0,-201
16417,1,0,94,0,-94
16418,0,0,18,0,-18
16419,1,0,0,0,0
16420,0,0,22,0,-22
16421,0,0,7,0,-7
16422,0,0,94,0,-94
16423,0,0,46,0,-46
16424,1,0,53,0,-53
16425,1,0,30,0,-30
16426,1,1,1100,1264,164
16427,1,1,1294,1526,232
16428,1,0,13,0,-13
16429,1,1,254,1946,1692
16430,1,1,166,1269,1103
16431,0,0,16,0,-16
16432,1,1,1285,1290,5
16433,0,0,3,0,-3
16434,0,0,21,0,-21
16435,1,1,408,1827,1419
16436,0,0,10,0,-10
16437,0,0,89,0,-89
16438,0,0,58,0,-58
16439,0,0,99,0,-99
16440,1,0,57,0,-57
16441,0,0,52,0,-52
16442,0,0,5,0,-5
16443,0,0,9,0,-9
16444,1,0,80,0,-80
16445,1,0,23,0,-23
16446,1,1,171,1279,1108
16447,1,0,8,0,-8
16448,1,1,3946,1603,-2343
16449,1,0,48,0,-48
16450,1,0,51,0,-51
16451,0,0,93,0,-93
16452,1,1,408,1238,830
16453,1,1,671,1278,607
16454,1,0,205,0,-205
16455,1,1,148,1775,1627
16456,1,1,99,1736,1637
16457,1,0,226,0,-226
16458,0,0,4,0,-4
16459,1,1,1317,1297,-20
16460,0,0,200,0,-200
16461,0,0,57,0,-57
16462,1,1,192,1377,1185
16463,1,0,39,0,-39
16464,1,1,454,1249,795
16465,0,0,28,0,-28
16466,0,0,6,0,-6
16467,0,0,2,0,-2
16468,0,0,52,0,-52
16469,1,0,5,0,-5
16470,1,0,20,0,-20
16471,1,0,62,0,-62
16472,1,0,57,0,-57
16473,0,0,76,0,-76
16474,0,0,42,0,-42
16475,1,0,29,0,-29
16476,0,0,115,0,-115
16477,1,0,95,0,-95
16478,0,0,14,0,-14
16479,1,1,362,1472,1110
16480,1,0,13,0,-13
16481,1,0,145,0,-145
16482,0,0,23,0,-23
16483,0,0,26,0,-26
16484,1,1,127,1971,1844
16485,0,0,12,0,-12
16486,1,1,932,1424,492
16487,1,1,2094,1421,-673
16488,1,0,65,0,-65
16489,0,0,88,0,-88
16490,1,1,25,2091,2066
16491,1,0,52,0,-52
16492,0,0,15,0,-15
16493,0,0,27,0,-27
16494,1,0,71,0,-71
16495,1,0,15,0,-15
16496,0,0,49,0,-49
16497,1,1,133,1720,1587
16498,1,1,180,1673,1493
16499,0,0,190,0,-190
16500,1,1,1136,1217,81
16501,0,0,98,0,-98
16502,0,0,2,0,-2
16503,1,1,1360,1735,375
16504,0,0,34,0,-34
16505,0,0,32,0,-32
16506,0,0,91,0,-91
16507,1,1,459,1730,1271
16508,1,1,255,1761,1506
16509,1,1,1238,1233,-5
16510,1,1,414,1995,1581
16511,0,0,174,0,-174
16512,1,1,838,1231,393
16513,1,1,317,2535,2218
16514,1,0,20,0,-20
16515,1,0,44,0,-44
16516,1,1,568,1400,832
16517,1,1,513,1282,769
16518,1,1,1200,1557,357
16519,0,0,30,0,-30
16520,1,0,201,0,-201
16521,1,0,3,0,-3
16522,1,1,953,1357,404
16523,1,0,2,0,-2
16524,0,0,10,0,-10
16525,0,0,62,0,-62
16526,1,1,92,1874,1782
16527,0,0,193,0,-193
16528,0,0,40,0,-40
16529,0,0,17,0,-17
16530,0,0,45,0,-45
16531,1,0,7,0,-7
16532,1,0,15,0,-15
16533,0,0,35,0,-35
16534,1,0,3,0,-3
16535,0,0,73,0,-73
16536,0,0,103,0,-103
16537,0,0,0,0,0
16538,0,0,89,0,-89
16539,1,1,598,1238,640
16540,1,1,570,1271,701
16541,1,1,198,1209,1011
16542,1,0,26,0,-26
16543,1,1,1736,1205,-531
16544,1,0,78,0,-78
16545,0,0,4,0,-4
16546,1,1,321,1479,1158
16547,1,0,95,0,-95
16548,1,1,375,1467,1092
16549,1,1,686,1296,610
16550,1,0,32,0,-32
16551,0,0,18,0,-18
16552,0,0,9,0,-9
16553,0,0,43,0,-43
16554,0,0,13,0,-13
16555,0,0,51,0,-51
16556,0,0,50,0,-50
16557,1,0,54,0,-54
16558,1,1,1106,1565,459
16559,1,1,143,1324,1181
16560,1,0,12,0,-12
16561,0,0,8,0,-8
16562,1,1,428,1302,874
16563,0,0,120,0,-120
16564,0,0,131,0,-131
16565,1,0,6,0,-6
16566,0,0,45,0,-45
16567,1,0,88,0,-88
16568,0,0,27,0,-27
16569,0,0,11,0,-11
16570,1,1,1398,1300,-98
16571,1,0,18,0,-18
16572,0,0,9,0,-9
16573,1,1,172,1305,1133
16574,0,0,40,0,-40
16575,1,1,1014,1207,193
16576,0,0,2,0,-2
16577,1,0,9,0,-9
16578,0,0,27,0,-27
16579,1,1,1547,1223,-324
16580,0,0,122,0,-122
16581,1,1,416,5151,4735
16582,1,0,35,0,-35
16583,1,1,351,1496,1145
16584,1,0,16,0,-16
16585,0,0,21,0,-21
16586,1,0,79,0,-79
16587,1,1,928,1466,538
16588,1,1,1326,1317,-9
16589,1,1,210,1614,1404
16590,1,1,3210,1228,-1982
16591,1,0,139,0,-139
16592,1,1,1236,1216,-20
16593,1,1,80,1941,1861
16594,1,0,72,0,-72
16595,1,1,572,1531,959
16596,0,0,2,0,-2
16597,1,0,37,0,-37
16598,1,0,78,0,-78
16599,1,1,172,1934,1762
16600,1,0,3,0,-3
16601,1,0,42,0,-42
16602,1,0,42,0,-42
16603,1,0,2,0,-2
16604,1,1,467,1200,733
16605,1,1,651,1556,905
16606,0,0,102,0,-102
16607,1,0,3,0,-3
16608,1,1,325,1412,1087
16609,1,1,218,1375,1157
16610,1,0,148,0,-148
16611,0,0,58,0,-58
16612,0,0,201,0,-201
16613,0,0,14,0,-14
16614,1,0,8,0,-8
16615,1,0,144,0,-144
16616,1,1,160,1380,1220
16617,1,1,44,1470,1426
16618,1,0,12,0,-12
16619,1,0,16,0,-16
16620,1,1,555,1431,876
16621,1,0,11,0,-11
16622,0,0,144,0,-144
16623,1,0,45,0,-45
16624,0,0,7,0,-7
16625,1,0,73,0,-73
16626,1,1,818,1216,398
16627,1,1,42,9813,9771
16628,1,1,58,1509,1451
16629,1,1,92,1346,1254
16630,1,1,152,1240,1088
16631,0,0,102,0,-102
16632,0,0,52,0,-52
16633,1,1,1103,2924,1821
16634,0,0,89,0,-89
16635,1,1,313,2407,2094
16636,1,1,827,1983,1156
16637,1,1,575,1804,1229
16638,1,1,192,1454,1262
16639,1,0,85,0,-85
16640,1,0,21,0,-21
16641,0,0,1,0,-1
16642,1,0,39,0,-39
16643,1,0,44,0,-44
16644,1,0,26,0,-26
16645,1,1,788,2055,1267
16646,0,0,70,0,-70
16647,1,1,444,1616,1172
16648,1,0,13,0,-13
16649,1,0,70,0,-70
16650,1,0,77,0,-77
16651,1,0,9,0,-9
16652,0,0,128,0,-128
16653,0,0,27,0,-27
16654,1,0,1,0,-1
16655,0,0,1,0,-1
16656,1,0,2,0,-2
16657,0,0,44,0,-44
16658,0,0,43,0,-43
16659,0,0,66,0,-66
16660,1,1,190,1789,1599
16661,0,0,9,0,-9
16662,0,0,19,0,-19
16663,0,0,23,0,-23
16664,1,1,432,1560,1128
16665,0,0,53,0,-53
16666,1,1,681,1238,557
16667,1,1,256,3577,3321
16668,0,0,110,0,-110
16669,1,0,47,0,-47
16670,1,0,25,0,-25
16671,1,1,554,3502,2948
16672,1,1,170,2243,2073
16673,0,0,9,0,-9
16674,1,1,567,1319,752
16675,1,1,95,1308,1213
16676,0,0,31,0,-31
16677,1,0,24,0,-24
16678,0,0,94,0,-94
16679,0,0,24,0,-24
16680,1,0,12,0,-12
16681,0,0,72,0,-72
16682,1,1,115,1336,1221
16683,1,0,11,0,-11
16684,1,1,213,1336,1123
16685,1,0,26,0,-26
16686,1,1,1780,1269,-511
16687,0,0,58,0,-58
16688,0,0,4,0,-4
16689,1,0,21,0,-21
16690,1,0,108,0,-108
16691,0,0,132,0,-132
16692,1,1,990,1622,632
16693,1,0,41,0,-41
16694,0,0,2,0,-2
16695,1,1,1640,1901,261
16696,1,0,173,0,-173
16697,0,0,61,0,-61
16698,0,0,27,0,-27
16699,1,1,259,1533,1274
16700,0,0,132,0,-132
16701,0,0,61,0,-61
16702,1,0,17,0,-17
16703,1,1,445,1407,962
16704,1,0,37,0,-37
16705,1,0,41,0,-41
16706,1,1,877,2724,1847
16707,1,0,29,0,-29
16708,1,0,10,0,-10
16709,1,1,35,1421,1386
16710,1,0,29,0,-29
16711,1,0,38,0,-38
16712,0,0,237,0,-237
16713,0,0,52,0,-52
16714,0,0,78,0,-78
16715,0,0,9,0,-9
16716,0,0,48,0,-48
16717,1,1,84,1231,1147
16718,1,1,326,1498,1172
16719,1,1,399,2555,2156
16720,1,0,27,0,-27
16721,0,0,46,0,-46
16722,0,0,1,0,-1
16723,1,1,550,1294,744
16724,1,0,106,0,-106
16725,1,0,2,0,-2
16726,0,0,52,0,-52
16727,1,1,147,1538,1391
16728,1,0,35,0,-35
16729,1,0,21,0,-21
16730,0,0,35,0,-35
16731,1,1,89,1245,1156
16732,0,0,14,0,-14
16733,0,0,68,0,-68
16734,0,0,23,0,-23
16735,0,0,45,0,-45
16736,1,1,424,1530,1106
16737,1,0,37,0,-37
16738,1,0,137,0,-137
16739,1,1,250,1599,1349
16740,1,1,133,1361,1228
16741,0,0,103,0,-103
16742,1,1,150,1321,1171
16743,0,0,243,0,-243
16744,1,1,109,1362,1253
16745,1,0,29,0,-29
16746,1,1,2312,1202,-1110
16747,0,0,56,0,-56
16748,1,0,6,0,-6
16749,0,0,55,0,-55
16750,1,1,1020,1227,207
16751,0,0,249,0,-249
16752,0,0,0,0,0
16753,1,0,18,0,-18
16754,1,0,20,0,-20
16755,0,0,0,0,0
16756,1,0,41,0,-41
16757,0,0,5,0,-5
16758,1,0,57,0,-57
16759,1,0,15,0,-15
16760,1,1,211,1365,1154
16761,0,0,3,0,-3
16762,1,1,355,1359,1004
16763,1,0,9,0,-9
16764,1,0,45,0,-45
16765,1,1,860,1267,407
16766,1,1,113,1627,1514
16767,1,0,1,0,-1
16768,1,1,1198,1272,74
16769,1,0,36,0,-36
16770,0,0,50,0,-50
16771,1,1,120,2336,2216
16772,1,1,193,1652,1459
16773,0,0,63,0,-63
16774,1,0,35,0,-35
16775,1,0,34,0,-34
16776,1,0,4,0,-4
16777,1,1,2134,1289,-845
16778,1,1,148,2277,2129
16779,0,0,17,0,-17
16780,0,0,40,0,-40
16781,1,1,689,1705,1016
16782,0,0,72,0,-72
16783,1,0,115,0,-115
16784,0,0,10,0,-10
16785,1,0,18,0,-18
16786,1,1,1282,1767,485
16787,1,1,489,1373,884
16788,0,0,106,0,-106
16789,1,1,312,1207,895
16790,0,0,39,0,-39
16791,0,0,40,0,-40
16792,1,0,12,0,-12
16793,1,0,80,0,-80
16794,1,1,190,1445,1255
16795,0,0,18,0,-18
16796,1,0,63,0,-63
16797,1,0,171,0,-171
16798,1,1,769,1507,738
16799,1,0,2,0,-2
16800,0,0,17,0,-17
16801,1,0,5,0,-5
16802,1,0,45,0,-45
16803,1,0,86,0,-86
16804,0,0,85,0,-85
16805,1,0,64,0,-64
16806,1,0,14,0,-14
16807,1,1,292,1468,1176
16808,1,1,28,1444,1416
16809,1,1,358,1206,848
16810,1,0,52,0,-52
16811,1,0,44,0,-44
16812,1,0,44,0,-44
16813,1,0,118,0,-118
16814,1,0,45,0,-45
16815,1,1,1357,1303,-54
16816,0,0,90,0,-90
16817,0,0,17,0,-17
16818,1,1,909,1236,327
16819,1,0,7,0,-7
16820,0,0,69,0,-69
16821,0,0,56,0,-56
16822,0,0,66,0,-66
16823,0,0,3,0,-3
16824,1,0,4,0,-4
16825,0,0,23,0,-23
16826,0,0,103,0,-103
16827,0,0,105,0,-105
16828,0,0,49,0,-49
16829,1,0,83,0,-83
16830,1,1,54,2254,2200
16831,1,0,30,0,-30
16832,1,1,59,2059,2000
16833,0,0,88,0,-88
16834,1,0,161,0,-161
16835,1,1,166,1399,1233
16836,0,0,240,0,-240
16837,0,0,99,0,-99
16838,1,1,439,1283,844
16839,1,0,31,0,-31
16840,0,0,76,0,-76
16841,1,1,126,1539,1413
16842,0,0,10,0,-10
16843,1,0,136,0,-136
16844,0,0,99,0,-99
16845,1,1,369,2285,1916
16846,1,0,24,0,-24
16847,0,0,12,0,-12
16848,1,0,38,0,-38
16849,1,0,4,0,-4
16850,1,0,26,0,-26
16851,1,0,67,0,-67
16852,0,0,100,0,-100
16853,1,0,30,0,-30
16854,1,1,2313,2483,170
16855,0,0,48,0,-48
16856,1,0,66,0,-66
16857,1,1,62,1640,1578
16858,1,1,394,2064,1670
16859,1,1,633,1485,852
16860,0,0,20,0,-20
16861,1,1,497,1590,1093
16862,1,1,2431,1232,-1199
16863,0,0,41,0,-41
16864,0,0,0,0,0
16865,0,0,1,0,-1
16866,1,1,1298,1610,312
16867,0,0,25,0,-25
16868,0,0,12,0,-12
16869,1,1,580,1253,673
16870,0,0,134,0,-134
16871,0,0,1,0,-1
16872,0,0,17,0,-17
16873,1,0,52,0,-52
16874,1,1,117,1414,1297
16875,1,0,3,0,-3
16876,1,1,709,1852,1143
16877,1,1,1286,1435,149
16878,0,0,7,0,-7
16879,1,1,462,1793,1331
16880,1,1,1045,1528,483
16881,1,0,0,0,0
16882,1,0,10,0,-10
16883,0,0,40,0,-40
16884,0,0,159,0,-159
16885,0,0,19,0,-19
16886,1,1,459,2704,2245
16887,1,0,0,0,0
16888,1,0,30,0,-30
16889,0,0,67,0,-67
16890,1,0,0,0,0
16891,1,0,10,0,-10
16892,0,0,30,0,-30
16893,0,0,30,0,-30
16894,1,0,272,0,-272
16895,1,1,99,1248,1149
16896,1,0,0,0,0
16897,1,0,10,0,-10
16898,1,0,32,0,-32
16899,1,0,33,0,-33
16900,1,1,382,1889,1507
16901,0,0,228,0,-228
16902,1,0,1,0,-1
16903,1,0,1,0,-1
16904,1,1,78,1599,1521
16905,1,1,122,1745,1623
16906,1,1,1049,1272,223
16907,1,1,212,1276,1064
16908,0,0,39,0,-39
16909,0,0,13,0,-13
16910,0,0,9,0,-9
16911,0,0,7,0,-7
16912,1,0,34,0,-34
16913,0,0,3,0,-3
16914,1,0,2,0,-2
16915,0,0,39,0,-39
16916,0,0,56,0,-56
16917,1,0,36,0,-36
16918,0,0,62,0,-62
16919,1,1,903,1402,499
16920,0,0,130,0,-130
16921,1,1,402,1293,891
16922,0,0,4,0,-4
16923,1,0,15,0,-15
16924,0,0,33,0,-33
16925,1,1,760,1377,617
16926,0,0,25,0,-25
16927,1,0,18,0,-18
16928,1,0,8,0,-8
16929,1,0,20,0,-20
16930,1,1,827,1274,447
16931,1,1,353,1797,1444
16932,1,0,32,0,-32
16933,0,0,26,0,-26
16934,1,1,180,2174,1994
16935,1,0,44,0,-44
16936,1,0,2,0,-2
16937,1,1,83,2128,2045
16938,1,1,123,1502,1379
16939,0,0,46,0,-46
16940,0,0,133,0,-133
16941,0,0,20,0,-20
16942,1,1,315,1423,1108
16943,1,0,41,0,-41
16944,1,0,29,0,-29
16945,1,1,301,1235,934
16946,0,0,46,0,-46
16947,1,0,12,0,-12
16948,1,0,115,0,-115
16949,1,0,79,0,-79
16950,1,0,12,0,-12
16951,0,0,28,0,-28
16952,1,0,29,0,-29
16953,0,0,209,0,-209
16954,0,0,23,0,-23
16955,1,1,1806,1444,-362
16956,1,1,1449,1425,-24
16957,1,1,742,1530,788
16958,1,1,1488,1239,-249
16959,0,0,49,0,-49
16960,1,1,347,1243,896
16961,1,0,52,0,-52
16962,1,0,16,0,-16
16963,0,0,42,0,-42
16964,1,1,873,1339,466
16965,1,0,123,0,-123
16966,1,1,661,1388,727
16967,1,0,130,0,-130
16968,1,1,302,1266,964
16969,1,0,33,0,-33
16970,0,0,123,0,-123
16971,0,0,23,0,-23
16972,1,1,435,1718,1283
16973,0,0,27,0,-27
16974,0,0,52,0,-52
16975,1,1,308,1678,1370
16976,1,1,375,2100,1725
16977,1,0,0,0,0
16978,1,1,165,1407,1242
16979,1,1,707,1977,1270
16980,0,0,11,0,-11
16981,1,0,136,0,-136
16982,0,0,21,0,-21
16983,1,1,44,2565,2521
16984,1,0,30,0,-30
16985,0,0,14,0,-14
16986,1,0,39,0,-39
16987,0,0,32,0,-32
16988,1,0,42,0,-42
16989,1,1,3472,1223,-2249
16990,1,1,1440,1259,-181
16991,0,0,134,0,-134
16992,1,0,62,0,-62
16993,1,0,198,0,-198
16994,1,0,53,0,-53
16995,0,0,104,0,-104
16996,1,1,828,1957,1129
16997,1,1,164,2653,2489
16998,1,1,475,1389,914
16999,1,1,65,1893,1828
17000,0,0,0,0,0
17001,0,0,20,0,-20
17002,1,1,1663,1754,91
17003,0,0,10,0,-10
17004,0,0,21,0,-21
17005,1,1,109,2032,1923
17006,1,0,79,0,-79
17007,1,1,596,1272,676
17008,1,0,23,0,-23
17009,1,1,327,1590,1263
17010,1,0,68,0,-68
17011,1,0,20,0,-20
17012,0,0,9,0,-9
17013,1,0,29,0,-29
17014,0,0,1,0,-1
17015,1,0,5,0,-5
17016,0,0,39,0,-39
17017,1,1,547,1875,1328
17018,1,1,1405,1305,-100
17019,0,0,17,0,-17
17020,0,0,76,0,-76
17021,0,0,32,0,-32
17022,0,0,33,0,-33
17023,0,0,37,0,-37
17024,1,0,23,0,-23
17025,1,1,58,1287,1229
17026,1,0,7,0,-7
17027,1,0,74,0,-74
17028,1,1,399,1790,1391
17029,0,0,64,0,-64
17030,1,1,439,1218,779
17031,0,0,48,0,-48
17032,1,0,46,0,-46
17033,0,0,25,0,-25
17034,1,1,599,1224,625
17035,0,0,9,0,-9
17036,1,1,246,1541,1295
17037,1,0,124,0,-124
17038,0,0,21,0,-21
17039,0,0,22,0,-22
17040,1,0,129,0,-129
17041,0,0,57,0,-57
17042,1,1,549,1260,711
17043,0,0,23,0,-23
17044,1,1,495,1558,1063
17045,1,1,1124,1297,173
17046,0,0,216,0,-216
17047,1,1,143,2207,2064
17048,1,1,262,1221,959
17049,1,1,37,1201,1164
17050,1,0,27,0,-27
17051,0,0,20,0,-20
17052,1,1,265,1766,1501
17053,0,0,49,0,-49
17054,1,1,644,1524,880
17055,1,1,818,1316,498
17056,1,0,31,0,-31
17057,1,0,36,0,-36
17058,0,0,67,0,-67
17059,1,0,82,0,-82
17060,1,0,26,0,-26
17061,1,0,9,0,-9
17062,0,0,22,0,-22
17063,0,0,8,0,-8
17064,1,1,595,1998,1403
17065,1,0,15,0,-15
17066,0,0,2,0,-2
17067,1,1,1084,1209,125
17068,0,0,5,0,-5
17069,0,0,52,0,-52
17070,0,0,67,0,-67
17071,1,0,39,0,-39
17072,1,1,1091,1232,141
17073,1,1,1093,1391,298
17074,0,0,7,0,-7
17075,1,0,19,0,-19
17076,0,0,35,0,-35
17077,1,1,256,1298,1042
17078,1,0,27,0,-27
17079,1,0,11,0,-11
17080,1,1,606,1273,667
17081,0,0,3,0,-3
17082,0,0,2,0,-2
17083,1,1,80,1677,1597
17084,0,0,27,0,-27
17085,1,0,1,0,-1
17086,0,0,0,0,0
17087,1,0,90,0,-90
17088,0,0,184,0,-184
17089,0,0,29,0,-29
17090,1,1,161,2385,2224
17091,1,1,92,1722,1630
17092,1,1,316,1203,887
17093,1,1,152,1263,1111
17094,0,0,42,0,-42
17095,0,0,49,0,-49
17096,1,0,10,0,-10
17097,0,0,22,0,-22
17098,0,0,3,0,-3
17099,0,0,8,0,-8
17100,1,1,169,1421,1252
17101,1,0,87,0,-87
17102,1,1,1374,1542,168
17103,1,1,1091,1272,181
17104,0,0,2,0,-2
17105,0,0,47,0,-47
17106,1,0,65,0,-65
17107,0,0,45,0,-45
17108,1,0,23,0,-23
17109,1,0,48,0,-48
17110,1,1,351,1459,1108
17111,0,0,24,0,-24
17112,1,1,289,2102,1813
17113,0,0,28,0,-28
17114,0,0,16,0,-16
17115,1,0,11,0,-11
17116,1,1,357,1336,979
17117,0,0,84,0,-84
17118,0,0,4,0,-4
17119,1,1,222,1411,1189
17120,0,0,187,0,-187
17121,1,0,8,0,-8
17122,0,0,3,0,-3
17123,0,0,30,0,-30
17124,1,1,412,1511,1099
17125,0,0,85,0,-85
17126,1,1,384,1718,1334
17127,1,1,22,1916,1894
17128,1,0,112,0,-112
17129,1,0,78,0,-78
17130,1,1,1320,2198,878
17131,0,0,167,0,-167
17132,0,0,53,0,-53
17133,0,0,26,0,-26
17134,1,1,78,3652,3574
17135,0,0,11,0,-11
17136,0,0,13,0,-13
17137,0,0,95,0,-95
17138,0,0,12,0,-12
17139,1,0,47,0,-47
17140,1,0,42,0,-42
17141,0,0,60,0,-60
17142,0,0,29,0,-29
17143,1,1,49,1679,1630
17144,1,0,20,0,-20
17145,1,1,854,1350,496
17146,0,0,6,0,-6
17147,1,0,35,0,-35
17148,1,1,694,1229,535
17149,1,1,278,1769,1491
17150,0,0,52,0,-52
17151,1,1,225,1821,1596
17152,0,0,0,0,0
17153,1,0,45,0,-45
17154,0,0,38,0,-38
17155,1,0,9,0,-9
17156,0,0,116,0,-116
17157,0,0,226,0,-226
17158,1,1,599,1916,1317
17159,1,0,8,0,-8
17160,1,0,75,0,-75
17161,1,0,74,0,-74
17162,1,1,3034,1213,-1821
17163,1,1,140,1376,1236
17164,1,0,89,0,-89
17165,1,1,128,1344,1216
17166,1,0,3,0,-3
17167,1,0,8,0,-8
17168,1,1,1086,1527,441
17169,1,1,494,1237,743
17170,1,1,410,1296,886
17171,1,0,33,0,-33
17172,1,0,11,0,-11
17173,1,0,89,0,-89
17174,0,0,3,0,-3
17175,1,1,981,2320,1339
17176,1,0,121,0,-121
17177,0,0,7,0,-7
17178,1,1,88,1216,1128
17179,1,1,155,1240,1085
17180,0,0,22,0,-22
17181,1,0,4,0,-4
17182,0,0,39,0,-39
17183,0,0,12,0,-12
17184,1,0,8,0,-8
17185,1,1,1057,1401,344
17186,0,0,7,0,-7
17187,1,1,1259,1363,104
17188,0,0,55,0,-55
17189,1,0,6,0,-6
17190,1,0,4,0,-4
17191,1,1,297,1237,940
17192,0,0,32,0,-32
17193,0,0,66,0,-66
17194,1,0,103,0,-103
17195,0,0,95,0,-95
17196,1,1,785,1486,701
17197,0,0,14,0,-14
17198,1,0,17,0,-17
17199,1,1,252,1468,1216
17200,0,0,8,0,-8
17201,1,1,1771,2802,1031
17202,1,0,0,0,0
17203,1,1,62,1625,1563
17204,1,0,129,0,-129
17205,0,0,10,0,-10
17206,1,1,90,1745,1655
17207,1,0,19,0,-19
17208,1,0,38,0,-38
17209,1,1,255,1305,1050
17210,0,0,40,0,-40
17211,0,0,5,0,-5
17212,1,1,260,1317,1057
17213,1,1,568,1223,655
17214,0,0,105,0,-105
17215,1,0,218,0,-218
17216,0,0,39,0,-39
17217,1,1,700,2114,1414
17218,1,0,41,0,-41
17219,1,0,51,0,-51
17220,1,1,1139,1308,169
17221,0,0,87,0,-87
17222,0,0,29,0,-29
17223,1,0,47,0,-47
17224,1,1,472,1204,732
17225,1,1,536,1238,702
17226,0,0,32,0,-32
17227,0,0,22,0,-22
17228,1,1,479,1228,749
17229,0,0,19,0,-19
17230,0,0,80,0,-80
17231,0,0,9,0,-9
17232,0,0,12,0,-12
17233,1,0,83,0,-83
17234,0,0,19,0,-19
17235,1,0,123,0,-123
17236,1,0,22,0,-22
17237,1,1,544,1262,718
17238,0,0,52,0,-52
17239,0,0,31,0,-31
17240,1,0,109,0,-109
17241,1,1,837,1206,369
17242,1,0,28,0,-28
17243,1,1,311,1518,1207
17244,1,1,1926,1270,-656
17245,1,0,124,0,-124
17246,0,0,9,0,-9
17247,0,0,2,0,-2
17248,0,0,59,0,-59
17249,1,0,9,0,-9
17250,1,1,523,2029,1506
17251,1,0,41,0,-41
17252,1,0,12,0,-12
17253,0,0,96,0,-96
17254,0,0,2,0,-2
17255,1,1,483,1807,1324
17256,0,0,1,0,-1
17257,0,0,12,0,-12
17258,0,0,56,0,-56
17259,1,0,134,0,-134
17260,0,0,76,0,-76
17261,1,1,356,1220,864
17262,1,0,278,0,-278
17263,1,1,741,1703,962
17264,1,0,53,0,-53
17265,1,1,1632,1261,-371
17266,1,1,211,1202,991
17267,0,0,3,0,-3
17268,0,0,44,0,-44
17269,1,0,28,0,-28
17270,1,0,34,0,-34
17271,1,1,205,1818,1613
17272,1,1,654,1565,911
17273,0,0,108,0,-108
17274,1,0,93,0,-93
17275,1,1,116,1519,1403
17276,1,0,4,0,-4
17277,1,0,21,0,-21
17278,1,1,758,1450,692
17279,0,0,28,0,-28
17280,0,0,9,0,-9
17281,1,1,955,1448,493
17282,0,0,82,0,-82
17283,1,0,39,0,-39
17284,1,1,420,1798,1378
17285,1,1,1179,1291,112
17286,0,0,8,0,-8
17287,0,0,45,0,-45
17288,1,1,362,1627,1265
17289,1,1,1547,1347,-200
17290,0,0,10,0,-10
17291,1,0,0,0,0
17292,1,0,39,0,-39
17293,0,0,21,0,-21
17294,1,1,419,1250,831
17295,0,0,10,0,-10
17296,0,0,120,0,-120
17297,0,0,93,0,-93
17298,1,0,98,0,-98
17299,1,0,27,0,-27
17300,0,0,4,0,-4
17301,0,0,51,0,-51
17302,0,0,49,0,-49
17303,1,1,136,1400,1264
17304,1,1,683,1587,904
17305,0,0,16,0,-16
17306,1,1,248,2092,1844
17307,0,0,12,0,-12
17308,0,0,8,0,-8
17309,0,0,41,0,-41
17310,1,0,74,0,-74
17311,1,0,41,0,-41
17312,1,1,605,1559,954
17313,1,1,387,1377,990
17314,1,1,1030,1573,543
17315,1,1,999,1297,298
17316,1,0,159,0,-159
17317,1,1,537,1268,731
17318,1,1,415,1937,1522
17319,1,1,1309,1341,32
17320,0,0,44,0,-44
17321,0,0,54,0,-54
17322,1,0,42,0,-42
17323,1,1,323,1364,1041
17324,0,0,9,0,-9
17325,0,0,4,0,-4
17326,1,1,978,1314,336
17327,1,0,20,0,-20
17328,0,0,6,0,-6
17329,1,0,28,0,-28
17330,1,0,33,0,-33
17331,0,0,4,0,-4
17332,1,0,160,0,-160
17333,0,0,26,0,-26
17334,1,0,44,0,-44
17335,1,0,10,0,-10
17336,1,0,172,0,-172
17337,1,1,167,1472,1305
17338,1,0,10,0,-10
17339,0,0,73,0,-73
17340,1,0,4,0,-4
17341,1,0,87,0,-87
17342,1,0,60,0,-60
17343,0,0,102,0,-102
17344,0,0,151,0,-151
17345,1,1,148,1621,1473
17346,0,0,11,0,-11
17347,0,0,0,0,0
17348,1,1,137,1313,1176
17349,1,0,61,0,-61
17350,1,0,114,0,-114
17351,1,1,343,2013,1670
17352,0,0,17,0,-17
17353,0,0,77,0,-77
17354,1,0,29,0,-29
17355,1,1,575,1590,1015
17356,0,0,41,0,-41
17357,1,0,44,0,-44
17358,0,0,41,0,-41
17359,1,1,128,1832,1704
17360,1,0,15,0,-15
17361,0,0,129,0,-129
17362,1,1,535,1312,777
17363,1,0,94,0,-94
17364,1,0,53,0,-53
17365,0,0,48,0,-48
17366,1,1,1785,1704,-81
17367,1,0,29,0,-29
17368,1,1,611,1258,647
17369,1,0,118,0,-118
17370,1,0,11,0,-11
17371,1,0,253,0,-253
17372,1,1,172,1232,1060
17373,0,0,52,0,-52
17374,1,1,57,1903,1846
17375,1,1,894,1272,378
17376,0,0,19,0,-19
17377,0,0,118,0,-118
17378,1,1,333,1452,1119
17379,0,0,20,0,-20
17380,0,0,32,0,-32
17381,1,1,772,1206,434
17382,1,1,1313,1990,677
17383,1,1,762,1858,1096
17384,1,0,99,0,-99
17385,0,0,47,0,-47
17386,1,1,552,1324,772
17387,0,0,153,0,-153
17388,0,0,31,0,-31
17389,0,0,5,0,-5
17390,1,1,555,1643,1088
17391,0,0,50,0,-50
17392,1,1,164,1575,1411
17393,0,0,74,0,-74
17394,1,1,291,1360,1069
17395,1,0,20,0,-20
17396,1,1,120,1854,1734
17397,1,0,27,0,-27
17398,1,0,5,0,-5
17399,0,0,5,0,-5
17400,0,0,68,0,-68
17401,1,0,54,0,-54
17402,0,0,37,0,-37
17403,0,0,18,0,-18
17404,1,1,1135,1977,842
17405,0,0,88,0,-88
17406,0,0,38,0,-38
17407,1,1,785,1414,629
17408,1,1,83,4661,4578
17409,0,0,91,0,-91
17410,0,0,89,0,-89
17411,1,0,61,0,-61
17412,1,0,15,0,-15
17413,0,0,0,0,0
17414,1,0,10,0,-10
17415,1,1,595,1424,829
17416,1,1,189,1293,1104
17417,1,0,12,0,-12
17418,1,0,180,0,-180
17419,1,0,69,0,-69
17420,1,0,3,0,-3
17421,1,0,8,0,-8
17422,0,0,24,0,-24
17423,0,0,20,0,-20
17424,1,1,721,5722,5001
17425,1,0,11,0,-11
17426,0,0,4,0,-4
17427,1,0,58,0,-58
17428,1,0,40,0,-40
17429,1,0,31,0,-31
17430,1,1,228,1372,1144
17431,0,0,4,0,-4
17432,1,1,233,1520,1287
17433,0,0,17,0,-17
17434,0,0,184,0,-184
17435,0,0,20,0,-20
17436,0,0,11,0,-11
17437,1,1,368,1334,966
17438,1,1,55,1262,1207
17439,0,0,17,0,-17
17440,1,0,43,0,-43
17441,0,0,9,0,-9
17442,1,1,624,1275,651
17443,1,0,4,0,-4
17444,1,1,210,1254,1044
17445,1,1,447,1564,1117
17446,0,0,63,0,-63
17447,0,0,5,0,-5
17448,1,0,34,0,-34
17449,1,1,421,1653,1232
17450,1,0,24,0,-24
17451,0,0,17,0,-17
17452,1,0,170,0,-170
17453,1,0,65,0,-65
17454,0,0,17,0,-17
17455,1,1,105,1400,1295
17456,0,0,134,0,-134
17457,0,0,6,0,-6
17458,0,0,3,0,-3
17459,0,0,78,0,-78
17460,1,0,27,0,-27
17461,1,1,245,1465,1220
17462,1,0,92,0,-92
17463,0,0,226,0,-226
17464,1,0,24,0,-24
17465,0,0,15,0,-15
17466,1,0,10,0,-10
17467,1,0,118,0,-118
17468,0,0,34,0,-34
17469,1,0,20,0,-20
17470,1,0,3,0,-3
17471,0,0,25,0,-25
17472,0,0,74,0,-74
17473,1,1,48,1347,1299
17474,0,0,10,0,-10
17475,0,0,32,0,-32
17476,0,0,53,0,-53
17477,0,0,67,0,-67
17478,1,1,166,1520,1354
17479,1,0,52,0,-52
17480,1,0,80,0,-80
17481,0,0,86,0,-86
17482,0,0,129,0,-129
17483,0,0,115,0,-115
17484,1,1,947,1414,467
17485,0,0,24,0,-24
17486,1,1,372,1539,1167
17487,0,0,12,0,-12
17488,1,1,327,1946,1619
17489,0,0,327,0,-327
17490,1,0,5,0,-5
17491,1,0,29,0,-29
17492,0,0,77,0,-77
17493,0,0,39,0,-39
17494,0,0,37,0,-37
17495,0,0,5,0,-5
17496,0,0,38,0,-38
17497,1,0,13,0,-13
17498,1,0,10,0,-10
17499,0,0,14,0,-14
17500,1,1,85,1235,1150
17501,1,0,112,0,-112
17502,0,0,2,0,-2
17503,1,1,270,2497,2227
17504,0,0,85,0,-85
17505,1,1,41,1214,1173
17506,1,0,64,0,-64
17507,0,0,82,0,-82
17508,0,0,22,0,-22
17509,1,0,14,0,-14
17510,1,0,95,0,-95
17511,0,0,146,0,-146
17512,1,1,12,2103,2091
17513,1,1,1026,1396,370
17514,0,0,148,0,-148
17515,0,0,1,0,-1
17516,1,0,39,0,-39
17517,1,1,886,1665,779
17518,1,1,835,1255,420
17519,0,0,19,0,-19
17520,1,0,55,0,-55
17521,1,1,489,1242,753
17522,0,0,22,0,-22
17523,0,0,47,0,-47
17524,1,0,20,0,-20
17525,1,0,75,0,-75
17526,0,0,51,0,-51
17527,0,0,29,0,-29
17528,0,0,14,0,-14
17529,1,0,43,0,-43
17530,1,0,66,0,-66
17531,1,0,2,0,-2
17532,0,0,58,0,-58
17533,0,0,50,0,-50
17534,1,1,962,1369,407
17535,1,1,212,1591,1379
17536,0,0,129,0,-129
17537,1,0,69,0,-69
17538,0,0,45,0,-45
17539,1,0,16,0,-16
17540,1,1,331,1944,1613
17541,0,0,42,0,-42
17542,1,1,1802,1587,-215
17543,1,1,427,2795,2368
17544,1,1,97,1231,1134
17545,1,1,60,1536,1476
17546,1,0,27,0,-27
17547,1,1,183,1447,1264
17548,1,0,0,0,0
17549,0,0,85,0,-85
17550,1,1,388,1621,1233
17551,1,0,37,0,-37
17552,1,0,232,0,-232
17553,1,0,29,0,-29
17554,1,1,180,1641,1461
17555,1,1,217,1303,1086
17556,0,0,33,0,-33
17557,0,0,33,0,-33
17558,0,0,118,0,-118
17559,0,0,22,0,-22
17560,1,1,280,1412,1132
17561,1,0,13,0,-13
17562,1,1,400,2285,1885
17563,1,1,77,1717,1640
17564,0,0,6,0,-6
17565,1,0,65,0,-65
17566,1,1,841,2029,1188
17567,0,0,22,0,-22
17568,1,0,35,0,-35
17569,0,0,2,0,-2
17570,1,0,114,0,-114
17571,1,1,457,1307,850
17572,0,0,10,0,-10
17573,1,0,2,0,-2
17574,1,0,44,0,-44
17575,0,0,39,0,-39
17576,0,0,0,0,0
17577,0,0,134,0,-134
17578,0,0,5,0,-5
17579,1,0,45,0,-45
17580,0,0,7,0,-7
17581,0,0,51,0,-51
17582,0,0,37,0,-37
17583,0,0,46,0,-46
17584,0,0,26,0,-26
17585,0,0,62,0,-62
17586,0,0,44,0,-44
17587,1,1,92,1285,1193
17588,0,0,52,0,-52
17589,0,0,69,0,-69
17590,1,0,6,0,-6
17591,1,1,1404,1471,67
17592,1,0,10,0,-10
17593,1,1,243,1689,1446
17594,0,0,1,0,-1
17595,1,1,1836,2400,564
17596,1,0,22,0,-22
17597,1,1,1605,1679,74
17598,0,0,22,0,-22
17599,1,1,626,1270,644
17600,1,0,53,0,-53
17601,1,0,12,0,-12
17602,1,0,42,0,-42
17603,0,0,22,0,-22
17604,1,1,703,1207,504
17605,1,0,50,0,-50
17606,1,1,1949,1377,-572
17607,1,1,1096,1583,487
17608,1,1,812,1354,542
17609,1,0,69,0,-69
17610,1,0,32,0,-32
17611,0,0,21,0,-21
17612,1,0,0,0,0
17613,1,0,35,0,-35
17614,0,0,8,0,-8
17615,0,0,2,0,-2
17616,0,0,234,0,-234
17617,0,0,148,0,-148
17618,0,0,104,0,-104
17619,0,0,24,0,-24
17620,0,0,15,0,-15
17621,0,0,55,0,-55
17622,1,1,150,1372,1222
17623,1,1,1330,1625,295
17624,1,1,2054,1542,-512
17625,1,1,135,1345,1210
17626,1,1,883,1211,328
17627,1,1,233,1366,1133
17628,1,0,25,0,-25
17629,1,1,223,1433,1210
17630,1,0,2,0,-2
17631,0,0,106,0,-106
17632,0,0,99,0,-99
17633,1,1,130,1343,1213
17634,1,1,2503,2272,-231
17635,1,1,587,1200,613
17636,1,0,40,0,-40
17637,0,0,2,0,-2
17638,1,1,500,1257,757
17639,0,0,61,0,-61
17640,0,0,224,0,-224
17641,1,0,72,0,-72
17642,1,1,58,1544,1486
17643,1,0,84,0,-84
17644,0,0,93,0,-93
17645,0,0,109,0,-109
17646,1,1,135,1542,1407
17647,1,1,60,1289,1229
17648,1,0,74,0,-74
17649,0,0,14,0,-14
17650,1,0,36,0,-36
17651,0,0,27,0,-27
17652,1,1,1342,1202,-140
17653,0,0,7,0,-7
17654,0,0,4,0,-4
17655,0,0,2,0,-2
17656,0,0,13,0,-13
17657,0,0,75,0,-75
17658,0,0,119,0,-119
17659,1,1,2169,1218,-951
17660,1,1,209,1208,999
17661,1,1,692,1409,717
17662,0,0,90,0,-90
17663,1,0,22,0,-22
17664,1,0,28,0,-28
17665,1,1,587,1697,1110
17666,1,0,28,0,-28
17667,0,0,92,0,-92
17668,0,0,79,0,-79
17669,1,0,75,0,-75
17670,0,0,43,0,-43
17671,1,1,2188,1232,-956
17672,0,0,12,0,-12
17673,0,0,4,0,-4
17674,1,0,63,0,-63
17675,0,0,24,0,-24
17676,1,0,25,0,-25
17677,1,1,241,1588,1347
17678,1,0,3,0,-3
17679,0,0,69,0,-69
17680,0,0,31,0,-31
17681,1,0,5,0,-5
17682,0,0,1,0,-1
17683,1,0,107,0,-107
17684,1,0,45,0,-45
17685,0,0,7,0,-7
17686,1,0,27,0,-27
17687,1,0,41,0,-41
17688,0,0,16,0,-16
17689,0,0,57,0,-57
17690,1,1,1079,1818,739
17691,1,0,93,0,-93
17692,1,0,28,0,-28
17693,1,0,32,0,-32
17694,1,0,37,0,-37
17695,1,1,288,1235,947
17696,1,1,172,2786,2614
17697,1,1,102,1284,1182
17698,1,1,69,2810,2741
17699,0,0,239,0,-239
17700,0,0,20,0,-20
17701,0,0,81,0,-81
17702,1,1,397,1486,1089
17703,1,0,11,0,-11
17704,1,1,306,1497,1191
17705,1,0,86,0,-86
17706,1,0,17,0,-17
17707,1,0,21,0,-21
17708,1,1,539,1516,977
17709,0,0,3,0,-3
17710,0,0,46,0,-46
17711,0,0,4,0,-4
17712,0,0,23,0,-23
17713,1,0,179,0,-179
17714,0,0,121,0,-121
17715,0,0,8,0,-8
17716,1,0,23,0,-23
17717,1,1,1532,1377,-155
17718,1,0,167,0,-167
17719,1,0,39,0,-39
17720,1,0,8,0,-8
17721,1,1,315,1872,1557
17722,1,0,8,0,-8
17723,1,0,51,0,-51
17724,1,1,310,1371,1061
17725,0,0,173,0,-173
17726,1,0,93,0,-93
17727,1,1,693,1295,602
17728,0,0,23,0,-23
17729,1,1,925,1686,761
17730,1,1,321,2966,2645
17731,0,0,145,0,-145
17732,0,0,75,0,-75
17733,1,1,1026,1332,306
17734,0,0,199,0,-199
17735,1,1,140,1287,1147
17736,1,0,21,0,-21
17737,0,0,17,0,-17
17738,1,0,23,0,-23
17739,1,0,27,0,-27
17740,1,0,112,0,-112
17741,0,0,120,0,-120
17742,1,0,18,0,-18
17743,0,0,4,0,-4
17744,0,0,23,0,-23
17745,0,0,23,0,-23
17746,1,0,68,0,-68
17747,0,0,37,0,-37
17748,0,0,60,0,-60
17749,0,0,42,0,-42
17750,1,0,10,0,-10
17751,1,1,1694,1626,-68
17752,0,0,52,0,-52
17753,1,0,78,0,-78
17754,1,1,594,1506,912
17755,0,0,94,0,-94
17756,1,1,412,1369,957
17757,1,1,496,1745,1249
17758,1,0,234,0,-234
17759,0,0,14,0,-14
17760,1,0,23,0,-23
17761,0,0,34,0,-34
17762,1,1,770,1331,561
17763,0,0,46,0,-46
17764,1,1,241,1458,1217
17765,1,0,66,0,-66
17766,1,1,280,1456,1176
17767,0,0,21,0,-21
17768,1,0,26,0,-26
17769,1,1,110,1254,1144
17770,0,0,60,0,-60
17771,0,0,109,0,-109
17772,0,0,82,0,-82
17773,0,0,21,0,-21
17774,1,1,198,1652,1454
17775,0,0,147,0,-147
17776,1,0,71,0,-71
17777,1,0,68,0,-68
17778,1,1,292,1882,1590
17779,0,0,95,0,-95
17780,0,0,118,0,-118
17781,0,0,9,0,-9
17782,0,0,84,0,-84
17783,1,0,35,0,-35
17784,1,0,5,0,-5
17785,0,0,147,0,-147
17786,1,0,18,0,-18
17787,1,1,188,1271,1083
17788,1,1,1098,4465,3367
17789,1,0,126,0,-126
17790,1,0,135,0,-135
17791,1,1,248,1422,1174
17792,1,1,370,1402,1032
17793,0,0,43,0,-43
17794,0,0,44,0,-44
17795,1,0,87,0,-87
17796,0,0,15,0,-15
17797,0,0,9,0,-9
17798,1,0,102,0,-102
17799,0,0,28,0,-28
17800,1,1,797,1262,465
17801,1,1,79,1571,1492
17802,1,1,328,1440,1112
17803,1,1,2581,1208,-1373
17804,1,0,113,0,-113
17805,1,0,2,0,-2
17806,1,1,107,1416,1309
17807,0,0,25,0,-25
17808,1,1,113,1840,1727
17809,1,0,56,0,-56
17810,0,0,81,0,-81
17811,1,1,1643,2323,680
17812,1,1,912,1972,1060
17813,0,0,29,0,-29
17814,1,0,17,0,-17
17815,1,0,15,0,-15
17816,0,0,0,0,0
17817,1,1,162,1382,1220
17818,1,1,321,1652,1331
17819,0,0,11,0,-11
17820,1,1,60,1677,1617
17821,0,0,21,0,-21
17822,1,1,782,1823,1041
17823,1,0,10,0,-10
17824,0,0,83,0,-83
17825,1,1,344,1235,891
17826,1,1,832,1650,818
17827,1,0,18,0,-18
17828,1,1,21,1554,1533
17829,1,1,101,1397,1296
17830,0,0,38,0,-38
17831,1,1,174,1975,1801
17832,0,0,67,0,-67
17833,0,0,145,0,-145
17834,1,1,1234,1601,367
17835,1,1,439,3245,2806
17836,1,1,361,1556,1195
17837,0,0,25,0,-25
17838,1,0,9,0,-9
17839,1,1,194,1385,1191
17840,1,1,734,1217,483
17841,0,0,74,0,-74
17842,0,0,24,0,-24
17843,1,0,29,0,-29
17844,0,0,7,0,-7
17845,1,1,604,1664,1060
17846,1,0,59,0,-59
17847,1,0,152,0,-152
17848,0,0,10,0,-10
17849,1,0,1,0,-1
17850,0,0,22,0,-22
17851,1,1,631,1264,633
17852,1,0,4,0,-4
17853,0,0,21,0,-21
17854,1,1,39,1353,1314
17855,1,0,117,0,-117
17856,1,1,161,1257,1096
17857,1,1,875,3964,3089
17858,0,0,238,0,-238
17859,1,0,141,0,-141
17860,1,1,479,1367,888
17861,0,0,7,0,-7
17862,1,0,11,0,-11
17863,1,0,19,0,-19
17864,1,1,728,1205,477
17865,0,0,13,0,-13
17866,1,1,432,1440,1008
17867,0,0,79,0,-79
17868,0,0,11,0,-11
17869,1,0,27,0,-27
17870,0,0,28,0,-28
17871,0,0,32,0,-32
17872,1,0,49,0,-49
17873,1,0,85,0,-85
17874,0,0,30,0,-30
17875,0,0,3,0,-3
17876,0,0,21,0,-21
17877,0,0,51,0,-51
17878,0,0,30,0,-30
17879,0,0,12,0,-12
17880,1,1,260,1458,1198
17881,0,0,1,0,-1
17882,0,0,203,0,-203
17883,0,0,14,0,-14
17884,1,1,779,1625,846
17885,0,0,58,0,-58
17886,0,0,12,0,-12
17887,1,0,99,0,-99
17888,1,1,109,2069,1960
17889,0,0,30,0,-30
17890,1,0,3,0,-3
17891,1,1,670,1539,869
17892,0,0,51,0,-51
17893,1,0,44,0,-44
17894,1,1,450,1419,969
17895,0,0,47,0,-47
17896,1,0,30,0,-30
17897,1,1,163,1236,1073
17898,1,1,270,1630,1360
17899,1,1,86,2013,1927
17900,0,0,43,0,-43
17901,0,0,7,0,-7
17902,1,1,590,1466,876
17903,1,1,379,1231,852
17904,1,0,36,0,-36
17905,1,1,402,1234,832
17906,0,0,16,0,-16
17907,1,0,42,0,-42
17908,0,0,25,0,-25
17909,0,0,57,0,-57
17910,1,0,78,0,-78
17911,0,0,77,0,-77
17912,1,0,106,0,-106
17913,1,1,107,1842,1735
17914,1,0,17,0,-17
17915,0,0,35,0,-35
17916,1,1,404,1682,1278
17917,1,0,125,0,-125
17918,1,0,31,0,-31
17919,0,0,199,0,-199
17920,1,0,8,0,-8
17921,1,0,69,0,-69
17922,0,0,30,0,-30
17923,0,0,87,0,-87
17924,1,0,90,0,-90
17925,1,1,388,2609,2221
17926,1,0,7,0,-7
17927,0,0,100,0,-100
17928,0,0,24,0,-24
17929,1,1,330,3511,3181
17930,0,0,37,0,-37
17931,0,0,9,0,-9
17932,1,0,12,0,-12
17933,1,0,1,0,-1
17934,0,0,160,0,-160
17935,0,0,4,0,-4
17936,0,0,64,0,-64
17937,1,1,846,1525,679
17938,0,0,28,0,-28
17939,1,0,2,0,-2
17940,1,0,27,0,-27
17941,0,0,7,0,-7
17942,0,0,105,0,-105
17943,1,0,107,0,-107
17944,1,1,750,1606,856
17945,1,1,2574,1533,-1041
17946,1,1,57,1348,1291
17947,1,0,67,0,-67
17948,1,1,906,1773,867
17949,0,0,11,0,-11
17950,1,0,19,0,-19
17951,1,1,256,1263,1007
17952,1,1,771,1374,603
17953,0,0,16,0,-16
17954,1,0,46,0,-46
17955,1,1,387,2343,1956
17956,1,1,396,2392,1996
17957,0,0,56,0,-56
17958,1,1,591,1410,819
17959,1,0,1,0,-1
17960,1,1,1062,1463,401
17961,1,1,337,1530,1193
17962,0,0,35,0,-35
17963,1,1,568,1379,811
17964,1,0,50,0,-50
17965,0,0,6,0,-6
17966,1,0,29,0,-29
17967,0,0,14,0,-14
17968,0,0,172,0,-172
17969,1,1,647,2038,1391
17970,1,1,478,1469,991
17971,0,0,94,0,-94
17972,0,0,17,0,-17
17973,0,0,11,0,-11
17974,1,0,80,0,-80
17975,0,0,22,0,-22
17976,0,0,7,0,-7
17977,0,0,89,0,-89
17978,0,0,38,0,-38
17979,1,1,692,1218,526
17980,0,0,8,0,-8
17981,0,0,37,0,-37
17982,1,0,4,0,-4
17983,1,1,977,2444,1467
17984,0,0,23,0,-23
17985,1,0,30,0,-30
17986,0,0,40,0,-40
17987,1,1,923,1316,393
17988,1,1,1767,1335,-432
17989,0,0,58,0,-58
17990,0,0,83,0,-83
17991,1,0,31,0,-31
17992,1,1,574,1206,632
17993,1,0,56,0,-56
17994,1,0,10,0,-10
17995,1,1,446,1465,1019
17996,0,0,82,0,-82
17997,0,0,53,0,-53
17998,0,0,20,0,-20
17999,0,0,3,0,-3
18000,0,0,37,0,-37
18001,1,1,740,1335,595
18002,1,0,17,0,-17
18003,0,0,42,0,-42
18004,0,0,22,0,-22
18005,0,0,1,0,-1
18006,1,1,736,1958,1222
18007,1,1,487,2023,1536
18008,1,0,7,0,-7
18009,0,0,304,0,-304
18010,1,0,4,0,-4
18011,0,0,9,0,-9
18012,1,0,5,0,-5
18013,1,1,914,1373,459
18014,1,0,119,0,-119
18015,1,1,157,1790,1633
18016,0,0,1,0,-1
18017,1,0,29,0,-29
18018,0,0,197,0,-197
18019,1,1,106,1648,1542
18020,1,0,4,0,-4
18021,0,0,5,0,-5
18022,0,0,28,0,-28
18023,0,0,16,0,-16
18024,0,0,0,0,0
18025,0,0,13,0,-13
18026,1,1,701,1526,825
18027,1,0,108,0,-108
18028,1,1,17,1694,1677
18029,1,0,5,0,-5
18030,1,0,4,0,-4
18031,1,1,349,1244,895
18032,1,0,51,0,-51
18033,1,0,37,0,-37
18034,0,0,0,0,0
18035,0,0,177,0,-177
18036,1,0,27,0,-27
18037,1,0,21,0,-21
18038,1,0,15,0,-15
18039,1,1,989,1397,408
18040,0,0,12,0,-12
18041,1,0,104,0,-104
18042,0,0,47,0,-47
18043,0,0,16,0,-16
18044,0,0,3,0,-3
18045,0,0,9,0,-9
18046,1,1,179,2189,2010
18047,0,0,69,0,-69
18048,1,1,961,1221,260
18049,0,0,64,0,-64
18050,1,0,7,0,-7
18051,0,0,10,0,-10
18052,1,0,12,0,-12
18053,0,0,51,0,-51
18054,1,0,52,0,-52
18055,0,0,86,0,-86
18056,1,0,82,0,-82
18057,0,0,30,0,-30
18058,0,0,68,0,-68
18059,1,0,9,0,-9
18060,0,0,8,0,-8
18061,1,1,888,1398,510
18062,1,1,520,1357,837
18063,0,0,0,0,0
18064,1,1,146,3314,3168
18065,0,0,155,0,-155
18066,1,0,8,0,-8
18067,1,1,815,1424,609
18068,1,0,41,0,-41
18069,1,1,999,1530,531
18070,1,1,420,1292,872
18071,0,0,91,0,-91
18072,0,0,59,0,-59
18073,0,0,66,0,-66
18074,0,0,67,0,-67
18075,1,0,2,0,-2
18076,1,0,111,0,-111
18077,0,0,238,0,-238
18078,1,1,1695,1590,-105
18079,1,0,8,0,-8
18080,0,0,92,0,-92
18081,1,0,62,0,-62
18082,1,0,88,0,-88
18083,0,0,18,0,-18
18084,0,0,15,0,-15
18085,0,0,101,0,-101
18086,1,1,1204,1233,29
18087,1,0,9,0,-9
18088,1,1,170,1251,1081
18089,1,1,360,1394,1034
18090,1,0,28,0,-28
18091,1,1,2372,1253,-1119
18092,0,0,77,0,-77
18093,1,0,3,0,-3
18094,0,0,6,0,-6
18095,0,0,8,0,-8
18096,0,0,50,0,-50
18097,0,0,22,0,-22
18098,1,0,3,0,-3
18099,1,0,293,0,-293
18100,1,0,63,0,-63
18101,0,0,26,0,-26
18102,0,0,46,0,-46
18103,1,0,5,0,-5
18104,0,0,5,0,-5
18105,0,0,39,0,-39
18106,1,0,25,0,-25
18107,1,1,241,1223,982
18108,1,1,362,1460,1098
18109,1,0,59,0,-59
18110,1,1,344,1445,1101
18111,0,0,44,0,-44
18112,0,0,11,0,-11
18113,1,1,154,1590,1436
18114,0,0,85,0,-85
18115,0,0,194,0,-194
18116,1,0,129,0,-129
18117,1,0,29,0,-29
18118,0,0,7,0,-7
18119,0,0,183,0,-183
18120,0,0,300,0,-300
18121,1,0,0,0,0
18122,0,0,90,0,-90
18123,1,1,937,1247,310
18124,1,1,450,1419,969
18125,1,1,113,1519,1406
18126,1,0,0,0,0
18127,0,0,65,0,-65
18128,0,0,23,0,-23
18129,1,0,10,0,-10
18130,1,1,1340,1340,0
18131,1,1,1437,1398,-39
18132,0,0,117,0,-117
18133,0,0,3,0,-3
18134,1,0,155,0,-155
18135,0,0,14,0,-14
18136,0,0,29,0,-29
18137,1,0,30,0,-30
18138,1,1,714,1605,891
18139,1,0,8,0,-8
18140,1,0,10,0,-10
18141,0,0,40,0,-40
18142,0,0,103,0,-103
18143,0,0,130,0,-130
18144,1,1,261,1242,981
18145,0,0,52,0,-52
18146,0,0,37,0,-37
18147,1,1,737,1441,704
18148,0,0,5,0,-5
18149,1,1,78,1500,1422
18150,1,1,201,1203,1002
18151,0,0,60,0,-60
18152,0,0,30,0,-30
18153,0,0,8,0,-8
18154,1,0,63,0,-63
18155,1,1,1649,1209,-440
18156,0,0,18,0,-18
18157,0,0,73,0,-73
18158,0,0,46,0,-46
18159,1,0,15,0,-15
18160,1,1,652,1344,692
18161,1,0,5,0,-5
18162,0,0,18,0,-18
18163,1,1,801,1373,572
18164,1,0,78,0,-78
18165,0,0,3,0,-3
18166,1,1,125,1556,1431
18167,1,0,60,0,-60
18168,0,0,50,0,-50
18169,0,0,116,0,-116
18170,1,0,25,0,-25
18171,1,1,838,1832,994
18172,0,0,98,0,-98
18173,0,0,81,0,-81
18174,1,1,558,1592,1034
18175,1,0,220,0,-220
18176,0,0,0,0,0
18177,1,1,83,1562,1479
18178,0,0,111,0,-111
18179,1,1,308,1557,1249
18180,0,0,4,0,-4
18181,0,0,65,0,-65
18182,1,0,61,0,-61
18183,1,1,333,2251,1918
18184,1,0,89,0,-89
18185,0,0,0,0,0
18186,1,0,44,0,-44
18187,0,0,22,0,-22
18188,1,0,14,0,-14
18189,1,0,54,0,-54
18190,0,0,53,0,-53
18191,0,0,42,0,-42
18192,0,0,22,0,-22
18193,1,0,23,0,-23
18194,0,0,129,0,-129
18195,1,1,179,1353,1174
18196,1,1,583,1810,1227
18197,1,1,135,1461,1326
18198,1,0,213,0,-213
18199,0,0,75,0,-75
18200,1,1,359,1627,1268
18201,0,0,33,0,-33
18202,1,1,254,1779,1525
18203,1,1,417,1271,854
18204,0,0,141,0,-141
18205,1,1,2338,2006,-332
18206,0,0,41,0,-41
18207,0,0,76,0,-76
18208,0,0,158,0,-158
18209,0,0,52,0,-52
18210,1,1,40,2129,2089
18211,1,1,1052,1245,193
18212,1,1,2515,1558,-957
18213,1,1,312,1354,1042
18214,1,0,43,0,-43
18215,0,0,42,0,-42
18216,1,0,42,0,-42
18217,1,1,1013,2438,1425
18218,0,0,17,0,-17
18219,1,0,42,0,-42
18220,0,0,28,0,-28
18221,1,0,68,0,-68
18222,0,0,17,0,-17
18223,0,0,6,0,-6
18224,1,0,71,0,-71
18225,1,0,21,0,-21
18226,1,1,59,2186,2127
18227,0,0,100,0,-100
18228,1,1,1994,1632,-362
18229,0,0,99,0,-99
18230,1,0,66,0,-66
18231,0,0,150,0,-150
18232,1,0,14,0,-14
18233,0,0,70,0,-70
18234,0,0,2,0,-2
18235,1,0,34,0,-34
18236,1,1,48,1433,1385
18237,0,0,19,0,-19
18238,1,1,46,1693,1647
18239,1,0,45,0,-45
18240,0,0,76,0,-76
18241,0,0,9,0,-9
18242,0,0,34,0,-34
18243,0,0,100,0,-100
18244,1,0,87,0,-87
18245,1,0,22,0,-22
18246,0,0,12,0,-12
18247,1,1,739,1342,603
18248,0,0,0,0,0
18249,1,0,13,0,-13
18250,1,0,39,0,-39
18251,1,1,1030,4887,3857
18252,0,0,12,0,-12
18253,0,0,13,0,-13
18254,1,0,34,0,-34
18255,0,0,88,0,-88
18256,1,1,643,1288,645
18257,1,0,4,0,-4
18258,1,0,161,0,-161
18259,1,1,286,1370,1084
18260,1,0,44,0,-44
18261,1,1,1033,1334,301
18262,1,0,66,0,-66
18263,0,0,12,0,-12
18264,0,0,6,0,-6
18265,1,0,42,0,-42
18266,1,0,13,0,-13
18267,1,1,668,1504,836
18268,0,0,6,0,-6
18269,1,1,892,1843,951
18270,0,0,3,0,-3
18271,1,1,267,1578,1311
18272,0,0,53,0,-53
18273,0,0,45,0,-45
18274,1,0,61,0,-61
18275,0,0,82,0,-82
18276,1,0,1,0,-1
18277,1,1,298,1435,1137
18278,0,0,1,0,-1
18279,1,1,202,1457,1255
18280,0,0,41,0,-41
18281,1,0,4,0,-4
18282,1,0,63,0,-63
18283,1,1,725,1344,619
18284,0,0,1,0,-1
18285,1,1,339,2324,1985
18286,0,0,21,0,-21
18287,1,0,25,0,-25
18288,1,0,133,0,-133
18289,1,0,149,0,-149
18290,1,1,547,1237,690
18291,1,1,2101,2374,273
18292,0,0,94,0,-94
18293,0,0,5,0,-5
18294,0,0,120,0,-120
18295,1,1,181,1333,1152
18296,0,0,27,0,-27
18297,1,0,27,0,-27
18298,0,0,19,0,-19
18299,1,1,338,1417,1079
18300,1,0,11,0,-11
18301,0,0,12,0,-12
18302,0,0,108,0,-108
18303,0,0,148,0,-148
18304,0,0,23,0,-23
18305,1,0,82,0,-82
18306,0,0,53,0,-53
18307,0,0,26,0,-26
18308,0,0,9,0,-9
18309,0,0,34,0,-34
18310,0,0,26,0,-26
18311,0,0,75,0,-75
18312,0,0,14,0,-14
18313,1,1,1632,1465,-167
18314,1,0,9,0,-9
18315,1,0,49,0,-49
18316,1,0,27,0,-27
18317,1,0,48,0,-48
18318,1,1,468,1473,1005
18319,1,0,64,0,-64
18320,0,0,150,0,-150
18321,1,1,143,1292,1149
18322,1,1,1177,1472,295
18323,0,0,54,0,-54
18324,0,0,25,0,-25
18325,1,0,38,0,-38
18326,0,0,26,0,-26
18327,0,0,16,0,-16
18328,0,0,36,0,-36
18329,1,1,874,1230,356
18330,0,0,40,0,-40
18331,0,0,51,0,-51
18332,0,0,14,0,-14
18333,1,1,1080,1224,144
18334,0,0,73,0,-73
18335,1,0,50,0,-50
18336,1,1,695,1262,567
18337,1,1,745,1797,1052
18338,1,1,356,1309,953
18339,0,0,78,0,-78
18340,0,0,9,0,-9
18341,1,1,672,1208,536
18342,0,0,7,0,-7
18343,1,0,124,0,-124
18344,0,0,175,0,-175
18345,1,0,40,0,-40
18346,0,0,125,0,-125
18347,0,0,23,0,-23
18348,1,1,561,1549,988
18349,0,0,52,0,-52
18350,1,1,711,1221,510
18351,0,0,237,0,-237
18352,1,0,21,0,-21
18353,0,0,88,0,-88
18354,0,0,51,0,-51
18355,0,0,126,0,-126
18356,1,0,17,0,-17
18357,0,0,12,0,-12
18358,1,0,55,0,-55
18359,0,0,29,0,-29
18360,1,1,313,1555,1242
18361,1,1,1211,1381,170
18362,0,0,49,0,-49
18363,0,0,2,0,-2
18364,0,0,86,0,-86
18365,0,0,13,0,-13
18366,1,0,20,0,-20
18367,0,0,115,0,-115
18368,0,0,5,0,-5
18369,1,1,38,1872,1834
18370,1,0,56,0,-56
18371,0,0,181,0,-181
18372,1,1,459,1264,805
18373,0,0,246,0,-246
18374,1,1,378,1242,864
18375,1,1,90,1211,1121
18376,0,0,47,0,-47
18377,1,0,34,0,-34
18378,1,0,30,0,-30
18379,1,0,10,0,-10
18380,1,1,452,1445,993
18381,1,1,1523,1278,-245
18382,1,1,212,1395,1183
18383,1,1,233,1340,1107
18384,1,1,1261,1404,143
18385,1,1,973,1207,234
18386,0,0,71,0,-71
18387,1,1,1110,1853,743
18388,0,0,25,0,-25
18389,1,0,42,0,-42
18390,0,0,27,0,-27
18391,0,0,40,0,-40
18392,1,0,150,0,-150
18393,0,0,38,0,-38
18394,1,0,109,0,-109
18395,1,1,82,1871,1789
18396,0,0,98,0,-98
18397,0,0,25,0,-25
18398,1,1,878,1877,999
18399,1,0,82,0,-82
18400,1,0,23,0,-23
18401,0,0,2,0,-2
18402,0,0,145,0,-145
18403,1,0,24,0,-24
18404,1,1,681,1264,583
18405,0,0,49,0,-49
18406,1,0,87,0,-87
18407,1,1,34,1254,1220
18408,0,0,34,0,-34
18409,1,1,939,1272,333
18410,0,0,73,0,-73
18411,1,0,77,0,-77
18412,1,0,71,0,-71
18413,1,1,549,1980,1431
18414,0,0,164,0,-164
18415,1,1,274,3872,3598
18416,1,0,16,0,-16
18417,1,0,41,0,-41
18418,1,1,1506,1536,30
18419,1,1,176,1238,1062
18420,1,1,590,2461,1871
18421,0,0,8,0,-8
18422,1,0,98,0,-98
18423,0,0,15,0,-15
18424,0,0,190,0,-190
18425,0,0,3,0,-3
18426,0,0,64,0,-64
18427,0,0,75,0,-75
18428,1,0,5,0,-5
18429,0,0,31,0,-31
18430,1,1,341,1600,1259
18431,0,0,2,0,-2
18432,0,0,26,0,-26
18433,1,0,47,0,-47
18434,0,0,19,0,-19
18435,1,0,2,0,-2
18436,1,0,1,0,-1
18437,0,0,9,0,-9
18438,0,0,66,0,-66
18439,1,0,25,0,-25
18440,0,0,10,0,-10
18441,1,1,265,1600,1335
18442,1,0,9,0,-9
18443,1,0,50,0,-50
18444,0,0,31,0,-31
18445,1,0,89,0,-89
18446,0,0,83,0,-83
18447,1,1,489,1352,863
18448,1,0,23,0,-23
18449,0,0,68,0,-68
18450,0,0,13,0,-13
18451,0,0,8,0,-8
18452,1,0,1,0,-1
18453,1,1,42,1334,1292
18454,0,0,22,0,-22
18455,1,0,68,0,-68
18456,1,0,5,0,-5
18457,1,0,19,0,-19
18458,0,0,116,0,-116
18459,1,1,676,1249,573
18460,0,0,78,0,-78
18461,1,0,24,0,-24
18462,1,1,1042,1302,260
18463,0,0,70,0,-70
18464,1,1,254,1308,1054
18465,1,1,273,1309,1036
18466,1,0,32,0,-32
18467,0,0,83,0,-83
18468,0,0,30,0,-30
18469,1,1,118,1244,1126
18470,1,0,15,0,-15
18471,1,1,198,1231,1033
18472,1,0,169,0,-169
18473,1,1,190,1765,1575
18474,1,1,212,1377,1165
18475,1,1,821,1240,419
18476,0,0,53,0,-53
18477,0,0,239,0,-239
18478,1,1,101,1505,1404
18479,1,1,260,1845,1585
18480,0,0,312,0,-312
18481,0,0,27,0,-27
18482,0,0,37,0,-37
18483,0,0,5,0,-5
18484,1,0,51,0,-51
18485,1,0,81,0,-81
18486,1,1,531,1774,1243
18487,0,0,154,0,-154
18488,1,1,127,1217,1090
18489,0,0,118,0,-118
18490,0,0,19,0,-19
18491,0,0,89,0,-89
18492,0,0,104,0,-104
18493,1,1,397,1887,1490
18494,0,0,87,0,-87
18495,0,0,0,0,0
18496,1,0,45,0,-45
18497,1,0,65,0,-65
18498,0,0,176,0,-176
18499,1,1,105,1212,1107
18500,1,1,1347,2866,1519
18501,0,0,72,0,-72
18502,1,0,13,0,-13
18503,0,0,39,0,-39
18504,0,0,6,0,-6
18505,1,0,57,0,-57
18506,1,1,323,1221,898
18507,0,0,93,0,-93
18508,0,0,52,0,-52
18509,1,0,29,0,-29
18510,1,0,26,0,-26
18511,1,1,124,1372,1248
18512,1,1,165,1536,1371
18513,0,0,25,0,-25
18514,1,1,671,1456,785
18515,0,0,12,0,-12
18516,0,0,7,0,-7
18517,1,1,1047,1376,329
18518,0,0,99,0,-99
18519,1,1,82,1288,1206
18520,0,0,4,0,-4
18521,1,1,173,2212,2039
18522,1,1,223,1287,1064
18523,0,0,21,0,-21
18524,0,0,1,0,-1
18525,0,0,77,0,-77
18526,0,0,7,0,-7
18527,1,0,14,0,-14
18528,0,0,43,0,-43
18529,1,0,74,0,-74
18530,1,1,72,1544,1472
18531,0,0,122,0,-122
18532,1,0,18,0,-18
18533,1,0,26,0,-26
18534,1,0,26,0,-26
18535,1,1,292,1262,970
18536,1,1,355,1301,946
18537,1,0,6,0,-6
18538,1,1,1094,1489,395
18539,1,0,113,0,-113
18540,1,1,186,1260,1074
18541,1,1,165,1857,1692
18542,1,0,45,0,-45
18543,1,1,352,1331,979
18544,1,0,7,0,-7
18545,1,1,211,1477,1266
18546,1,1,521,1309,788
18547,0,0,61,0,-61
18548,0,0,28,0,-28
18549,1,1,309,1587,1278
18550,1,0,52,0,-52
18551,1,0,20,0,-20
18552,1,1,180,1562,1382
18553,1,0,33,0,-33
18554,1,0,25,0,-25
18555,0,0,57,0,-57
18556,1,0,10,0,-10
18557,0,0,38,0,-38
18558,1,0,79,0,-79
18559,1,1,107,2005,1898
18560,0,0,50,0,-50
18561,0,0,20,0,-20
18562,0,0,17,0,-17
18563,1,1,897,1327,430
18564,1,1,344,1358,1014
18565,1,0,136,0,-136
18566,1,0,81,0,-81
18567,0,0,2,0,-2
18568,0,0,89,0,-89
18569,1,1,294,1239,945
18570,0,0,50,0,-50
18571,0,0,97,0,-97
18572,0,0,17,0,-17
18573,0,0,42,0,-42
18574,0,0,37,0,-37
18575,1,0,12,0,-12
18576,0,0,55,0,-55
18577,1,0,74,0,-74
18578,1,0,112,0,-112
18579,1,0,55,0,-55
18580,0,0,51,0,-51
18581,1,1,1227,1374,147
18582,0,0,3,0,-3
18583,1,0,30,0,-30
18584,1,1,106,1411,1305
18585,1,1,303,2095,1792
18586,0,0,17,0,-17
18587,1,0,53,0,-53
18588,0,0,44,0,-44
18589,0,0,133,0,-133
18590,0,0,50,0,-50
18591,1,0,80,0,-80
18592,1,0,7,0,-7
18593,1,1,122,1250,1128
18594,1,1,679,1549,870
18595,0,0,65,0,-65
18596,0,0,75,0,-75
18597,1,0,45,0,-45
18598,1,0,0,0,0
18599,0,0,72,0,-72
18600,0,0,22,0,-22
18601,0,0,57,0,-57
18602,0,0,31,0,-31
18603,1,1,232,1519,1287
18604,1,1,911,1293,382
18605,0,0,53,0,-53
18606,0,0,46,0,-46
18607,1,0,133,0,-133
18608,1,0,23,0,-23
18609,0,0,22,0,-22
18610,1,1,492,1219,727
18611,1,1,714,1818,1104
18612,1,1,200,1353,1153
18613,1,1,382,1344,962
18614,1,1,161,2224,2063
18615,1,0,14,0,-14
18616,0,0,9,0,-9
18617,0,0,29,0,-29
18618,1,1,757,1206,449
18619,1,1,20,1871,1851
18620,1,0,16,0,-16
18621,0,0,35,0,-35
18622,0,0,28,0,-28
18623,1,1,95,1781,1686
18624,1,0,58,0,-58
18625,1,1,1003,1560,557
18626,0,0,2,0,-2
18627,1,0,28,0,-28
18628,0,0,60,0,-60
18629,0,0,118,0,-118
18630,1,0,26,0,-26
18631,1,1,784,1281,497
18632,1,1,94,1580,1486
18633,1,1,1040,1203,163
18634,0,0,2,0,-2
18635,1,1,168,1897,1729
18636,1,1,2451,1974,-477
18637,1,0,32,0,-32
18638,1,0,76,0,-76
18639,1,0,3,0,-3
18640,1,1,483,1201,718
18641,1,0,35,0,-35
18642,1,0,45,0,-45
18643,1,1,270,1292,1022
18644,0,0,4,0,-4
18645,1,1,88,1574,1486
18646,0,0,157,0,-157
18647,1,0,27,0,-27
18648,0,0,10,0,-10
18649,1,0,63,0,-63
18650,0,0,69,0,-69
18651,0,0,23,0,-23
18652,0,0,0,0,0
18653,1,0,82,0,-82
18654,0,0,20,0,-20
18655,0,0,12,0,-12
18656,1,1,290,1370,1080
18657,1,1,325,4282,3957
18658,0,0,15,0,-15
18659,0,0,46,0,-46
18660,0,0,36,0,-36
18661,0,0,97,0,-97
18662,1,0,40,0,-40
18663,1,0,21,0,-21
18664,1,0,14,0,-14
18665,1,0,1,0,-1
18666,0,0,4,0,-4
18667,1,1,1680,1685,5
18668,1,1,101,1397,1296
18669,1,0,67,0,-67
18670,1,1,1127,1546,419
18671,0,0,19,0,-19
18672,0,0,49,0,-49
18673,0,0,11,0,-11
18674,1,1,123,1207,1084
18675,1,0,46,0,-46
18676,1,1,461,1208,747
18677,1,0,23,0,-23
18678,1,1,613,1981,1368
18679,1,0,31,0,-31
18680,0,0,90,0,-90
18681,1,0,25,0,-25
18682,1,0,78,0,-78
18683,0,0,16,0,-16
18684,1,1,224,1206,982
18685,0,0,19,0,-19
18686,1,0,15,0,-15
18687,0,0,17,0,-17
18688,1,1,530,1264,734
18689,0,0,52,0,-52
18690,1,0,3,0,-3
18691,0,0,155,0,-155
18692,1,1,288,1301,1013
18693,0,0,9,0,-9
18694,1,0,61,0,-61
18695,1,0,17,0,-17
18696,1,0,2,0,-2
18697,1,0,9,0,-9
18698,0,0,28,0,-28
18699,0,0,50,0,-50
18700,1,0,77,0,-77
18701,1,1,726,1752,1026
18702,0,0,25,0,-25
18703,0,0,9,0,-9
18704,1,1,494,1652,1158
18705,0,0,85,0,-85
18706,1,1,432,1338,906
18707,1,1,671,1314,643
18708,1,1,23,1275,1252
18709,1,0,6,0,-6
18710,1,0,29,0,-29
18711,0,0,99,0,-99
18712,1,1,609,1308,699
18713,1,0,14,0,-14
18714,1,0,11,0,-11
18715,1,0,77,0,-77
18716,1,0,0,0,0
18717,0,0,34,0,-34
18718,0,0,9,0,-9
18719,1,1,436,1219,783
18720,1,0,6,0,-6
18721,0,0,29,0,-29
18722,0,0,118,0,-118
18723,1,1,102,1737,1635
18724,1,1,563,1224,661
18725,1,1,27,1426,1399
18726,1,1,3152,1398,-1754
18727,1,1,392,1530,1138
18728,1,0,38,0,-38
18729,1,0,1,0,-1
18730,1,0,5,0,-5
18731,0,0,87,0,-87
18732,0,0,42,0,-42
18733,1,0,82,0,-82
18734,0,0,29,0,-29
18735,1,1,534,1281,747
18736,1,0,190,0,-190
18737,1,1,929,2225,1296
18738,0,0,90,0,-90
18739,1,0,9,0,-9
18740,0,0,81,0,-81
18741,0,0,4,0,-4
18742,1,0,80,0,-80
18743,1,0,10,0,-10
18744,0,0,56,0,-56
18745,1,0,13,0,-13
18746,1,1,635,1446,811
18747,0,0,77,0,-77
18748,1,1,225,1448,1223
18749,0,0,106,0,-106
18750,0,0,1,0,-1
18751,0,0,65,0,-65
18752,0,0,2,0,-2
18753,1,0,63,0,-63
18754,0,0,35,0,-35
18755,1,0,41,0,-41
18756,1,0,52,0,-52
18757,0,0,67,0,-67
18758,1,1,424,1537,1113
18759,1,0,5,0,-5
18760,0,0,7,0,-7
18761,1,1,78,1420,1342
18762,1,0,124,0,-124
18763,0,0,13,0,-13
18764,0,0,59,0,-59
18765,0,0,44,0,-44
18766,1,1,228,1431,1203
18767,0,0,31,0,-31
18768,1,1,911,1608,697
18769,1,0,87,0,-87
18770,1,0,9,0,-9
18771,1,1,192,1776,1584
18772,1,0,0,0,0
18773,1,0,188,0,-188
18774,1,1,549,1539,990
18775,0,0,51,0,-51
18776,1,1,1183,1340,157
18777,0,0,55,0,-55
18778,1,1,377,1254,877
18779,1,1,1041,1333,292
18780,0,0,33,0,-33
18781,0,0,159,0,-159
18782,1,0,27,0,-27
18783,1,1,1005,1205,200
18784,0,0,39,0,-39
18785,0,0,29,0,-29
18786,0,0,4,0,-4
18787,1,0,42,0,-42
18788,1,1,26,1297,1271
18789,0,0,54,0,-54
18790,1,0,10,0,-10
18791,1,1,44,1418,1374
18792,0,0,5,0,-5
18793,1,1,159,1506,1347
18794,1,1,102,1283,1181
18795,1,1,197,1288,1091
18796,1,1,103,1225,1122
18797,1,0,5,0,-5
18798,0,0,30,0,-30
18799,1,0,107,0,-107
18800,0,0,38,0,-38
18801,1,1,108,1833,1725
18802,1,0,2,0,-2
18803,0,0,5,0,-5
18804,1,1,376,1593,1217
18805,0,0,13,0,-13
18806,1,0,7,0,-7
18807,0,0,55,0,-55
18808,1,0,18,0,-18
18809,1,0,12,0,-12
18810,0,0,30,0,-30
18811,1,1,251,2554,2303
18812,1,1,249,1719,1470
18813,0,0,85,0,-85
18814,1,0,8,0,-8
18815,0,0,20,0,-20
18816,1,0,81,0,-81
18817,0,0,79,0,-79
18818,0,0,36,0,-36
18819,1,1,905,1353,448
18820,1,0,20,0,-20
18821,0,0,4,0,-4
18822,0,0,5,0,-5
18823,0,0,31,0,-31
18824,0,0,139,0,-139
18825,0,0,4,0,-4
18826,0,0,1,0,-1
18827,1,1,533,1303,770
18828,1,0,1,0,-1
18829,1,0,12,0,-12
18830,0,0,74,0,-74
18831,1,1,570,1717,1147
18832,1,0,86,0,-86
18833,1,1,340,1378,1038
18834,1,1,171,1764,1593
18835,1,0,49,0,-49
18836,1,0,193,0,-193
18837,1,1,52,1521,1469
18838,1,0,5,0,-5
18839,1,0,14,0,-14
18840,1,1,2731,1479,-1252
18841,0,0,10,0,-10
18842,1,1,134,1475,1341
18843,1,0,22,0,-22
18844,1,0,2,0,-2
18845,0,0,7,0,-7
18846,1,1,692,1603,911
18847,1,1,1013,1356,343
18848,1,0,7,0,-7
18849,0,0,24,0,-24
18850,0,0,15,0,-15
18851,1,1,82,1826,1744
18852,1,0,58,0,-58
18853,1,1,909,1504,595
18854,1,0,31,0,-31
18855,1,1,257,1288,1031
18856,1,1,628,1261,633
18857,0,0,13,0,-13
18858,1,1,379,1846,1467
18859,1,0,124,0,-124
18860,0,0,11,0,-11
18861,1,1,865,2358,1493
18862,1,0,41,0,-41
18863,1,1,251,1377,1126
18864,1,1,213,1226,1013
18865,0,0,27,0,-27
18866,1,1,242,1524,1282
18867,1,1,104,1582,1478
18868,1,0,23,0,-23
18869,0,0,5,0,-5
18870,1,1,526,1248,722
18871,1,1,775,1229,454
18872,0,0,191,0,-191
18873,1,1,114,1342,1228
18874,1,1,93,1250,1157
18875,0,0,47,0,-47
18876,0,0,87,0,-87
18877,0,0,49,0,-49
18878,1,0,46,0,-46
18879,0,0,33,0,-33
18880,0,0,55,0,-55
18881,1,0,146,0,-146
18882,1,1,40,1237,1197
18883,1,1,1003,2268,1265
18884,0,0,62,0,-62
18885,1,0,4,0,-4
18886,1,0,73,0,-73
18887,1,0,7,0,-7
18888,1,1,165,1926,1761
18889,0,0,36,0,-36
18890,1,1,129,1457,1328
18891,1,0,20,0,-20
18892,0,0,4,0,-4
18893,1,0,12,0,-12
18894,0,0,13,0,-13
18895,1,1,616,1235,619
18896,0,0,15,0,-15
18897,0,0,8,0,-8
18898,1,0,29,0,-29
18899,1,1,960,1363,403
18900,1,0,30,0,-30
18901,0,0,22,0,-22
18902,0,0,32,0,-32
18903,0,0,25,0,-25
18904,0,0,5,0,-5
18905,0,0,35,0,-35
18906,1,0,8,0,-8
18907,1,0,0,0,0
18908,1,0,1,0,-1
18909,1,1,2142,1456,-686
18910,0,0,60,0,-60
18911,1,1,732,1675,943
18912,1,1,214,1401,1187
18913,1,0,40,0,-40
18914,1,1,381,1521,1140
18915,1,0,29,0,-29
18916,0,0,56,0,-56
18917,0,0,75,0,-75
18918,1,1,510,1861,1351
18919,1,1,111,1280,1169
18920,0,0,26,0,-26
18921,1,0,0,0,0
18922,0,0,15,0,-15
18923,0,0,0,0,0
18924,0,0,10,0,-10
18925,1,0,14,0,-14
18926,0,0,31,0,-31
18927,0,0,46,0,-46
18928,1,0,48,0,-48
18929,1,0,42,0,-42
18930,1,0,39,0,-39
18931,0,0,24,0,-24
18932,0,0,50,0,-50
18933,1,1,481,1322,841
18934,1,1,668,1228,560
18935,0,0,24,0,-24
18936,1,0,4,0,-4
18937,0,0,103,0,-103
18938,0,0,6,0,-6
18939,0,0,18,0,-18
18940,1,1,83,2125,2042
18941,0,0,34,0,-34
18942,1,0,104,0,-104
18943,0,0,171,0,-171
18944,1,0,79,0,-79
18945,1,1,101,1346,1245
18946,1,0,58,0,-58
18947,0,0,19,0,-19
18948,1,1,290,2142,1852
18949,0,0,26,0,-26
18950,1,0,23,0,-23
18951,0,0,17,0,-17
18952,0,0,14,0,-14
18953,1,0,13,0,-13
18954,1,0,74,0,-74
18955,1,0,13,0,-13
18956,1,0,71,0,-71
18957,1,1,329,2116,1787
18958,1,0,152,0,-152
18959,0,0,68,0,-68
18960,1,1,1336,2247,911
18961,1,1,1369,1876,507
18962,0,0,68,0,-68
18963,1,0,22,0,-22
18964,1,0,11,0,-11
18965,1,0,75,0,-75
18966,0,0,31,0,-31
18967,0,0,133,0,-133
18968,0,0,51,0,-51
18969,0,0,23,0,-23
18970,0,0,14,0,-14
18971,0,0,15,0,-15
18972,1,1,578,1446,868
18973,1,1,617,1706,1089
18974,0,0,1,0,-1
18975,1,1,603,1361,758
18976,0,0,1,0,-1
18977,1,1,583,1324,741
18978,1,0,41,0,-41
18979,0,0,27,0,-27
18980,0,0,15,0,-15
18981,1,1,337,1227,890
18982,1,0,119,0,-119
18983,0,0,30,0,-30
18984,1,1,550,1620,1070
18985,1,1,57,1215,1158
18986,0,0,2,0,-2
18987,1,1,163,1482,1319
18988,1,1,116,1247,1131
18989,0,0,95,0,-95
18990,1,0,33,0,-33
18991,1,1,1828,1479,-349
18992,0,0,53,0,-53
18993,1,0,1,0,-1
18994,1,0,62,0,-62
18995,0,0,84,0,-84
18996,0,0,17,0,-17
18997,0,0,20,0,-20
18998,0,0,186,0,-186
18999,0,0,53,0,-53
19000,1,1,111,1377,1266
19001,0,0,31,0,-31
19002,0,0,120,0,-120
19003,0,0,2,0,-2
19004,1,0,25,0,-25
19005,1,0,69,0,-69
19006,1,0,4,0,-4
19007,0,0,171,0,-171
19008,0,0,51,0,-51
19009,1,0,1,0,-1
19010,1,0,124,0,-124
19011,1,1,1343,1570,227
19012,1,1,237,1503,1266
19013,1,1,780,2045,1265
19014,0,0,78,0,-78
19015,0,0,44,0,-44
19016,1,0,31,0,-31
19017,1,0,35,0,-35
19018,1,0,54,0,-54
19019,0,0,36,0,-36
19020,1,0,6,0,-6
19021,0,0,9,0,-9
19022,0,0,32,0,-32
19023,1,1,28,1312,1284
19024,1,1,1675,1279,-396
19025,1,0,34,0,-34
19026,0,0,60,0,-60
19027,0,0,36,0,-36
19028,0,0,27,0,-27
19029,0,0,117,0,-117
19030,0,0,97,0,-97
19031,0,0,9,0,-9
19032,0,0,27,0,-27
19033,1,0,89,0,-89
19034,1,1,1045,1234,189
19035,0,0,13,0,-13
19036,1,0,116,0,-116
19037,0,0,19,0,-19
19038,0,0,2,0,-2
19039,1,1,256,1252,996
19040,0,0,10,0,-10
19041,0,0,23,0,-23
19042,1,0,82,0,-82
19043,1,1,961,1244,283
19044,1,0,14,0,-14
19045,0,0,19,0,-19
19046,0,0,185,0,-185
19047,1,0,271,0,-271
19048,1,0,132,0,-132
19049,1,1,256,1251,995
19050,1,1,181,1364,1183
19051,1,0,28,0,-28
19052,0,0,12,0,-12
19053,1,0,80,0,-80
19054,0,0,3,0,-3
19055,0,0,132,0,-132
19056,1,0,174,0,-174
19057,1,1,236,2261,2025
19058,0,0,10,0,-10
19059,1,0,1,0,-1
19060,1,0,240,0,-240
19061,1,0,73,0,-73
19062,0,0,30,0,-30
19063,1,1,101,1576,1475
19064,1,1,581,1332,751
19065,0,0,66,0,-66
19066,1,1,494,1238,744
19067,0,0,114,0,-114
19068,1,1,263,1957,1694
19069,0,0,44,0,-44
19070,0,0,38,0,-38
19071,1,0,33,0,-33
19072,1,1,197,1372,1175
19073,1,0,133,0,-133
19074,0,0,61,0,-61
19075,1,0,23,0,-23
19076,0,0,42,0,-42
19077,1,0,88,0,-88
19078,1,0,2,0,-2
19079,1,1,367,1907,1540
19080,0,0,19,0,-19
19081,1,1,166,2332,2166
19082,0,0,136,0,-136
19083,0,0,31,0,-31
19084,0,0,15,0,-15
19085,1,1,848,1331,483
19086,1,0,60,0,-60
19087,1,1,103,1250,1147
19088,1,1,641,1325,684
19089,1,0,32,0,-32
19090,1,0,31,0,-31
19091,0,0,18,0,-18
19092,0,0,0,0,0
19093,1,1,979,1528,549
19094,0,0,0,0,0
19095,1,1,777,1476,699
19096,1,1,304,1425,1121
19097,0,0,11,0,-11
19098,1,1,311,1443,1132
19099,1,1,472,1225,753
19100,1,1,66,1446,1380
19101,1,0,76,0,-76
19102,1,0,50,0,-50
19103,0,0,14,0,-14
19104,1,1,112,1242,1130
19105,1,0,155,0,-155
19106,0,0,64,0,-64
19107,0,0,187,0,-187
19108,1,0,21,0,-21
19109,1,1,579,1900,1321
19110,0,0,169,0,-169
19111,0,0,2,0,-2
19112,0,0,30,0,-30
19113,0,0,23,0,-23
19114,1,1,151,2877,2726
19115,0,0,26,0,-26
19116,1,1,966,1411,445
19117,0,0,46,0,-46
19118,1,1,458,1672,1214
19119,1,1,274,1351,1077
19120,1,1,1040,1331,291
19121,1,1,217,1283,1066
19122,1,0,60,0,-60
19123,1,0,230,0,-230
19124,1,1,478,1828,1350
19125,0,0,104,0,-104
19126,0,0,43,0,-43
19127,1,0,38,0,-38
19128,1,0,38,0,-38
19129,1,0,35,0,-35
19130,1,1,341,2126,1785
19131,1,1,604,1294,690
19132,0,0,4,0,-4
19133,1,0,10,0,-10
19134,1,1,122,1888,1766
19135,1,0,64,0,-64
19136,0,0,45,0,-45
19137,0,0,11,0,-11
19138,1,0,58,0,-58
19139,1,0,99,0,-99
19140,0,0,19,0,-19
19141,1,1,1424,1293,-131
19142,1,1,521,1908,1387
19143,1,1,716,1222,506
19144,1,1,131,1940,1809
19145,0,0,10,0,-10
19146,1,1,208,1747,1539
19147,1,0,204,0,-204
19148,1,0,28,0,-28
19149,0,0,37,0,-37
19150,1,0,81,0,-81
19151,1,1,199,1207,1008
19152,0,0,52,0,-52
19153,0,0,65,0,-65
19154,1,0,107,0,-107
19155,1,1,190,1499,1309
19156,1,0,256,0,-256
19157,1,0,18,0,-18
19158,1,1,188,1570,1382
19159,0,0,213,0,-213
19160,0,0,0,0,0
19161,1,1,327,1353,1026
19162,1,0,78,0,-78
19163,0,0,20,0,-20
19164,1,0,68,0,-68
19165,0,0,104,0,-104
19166,0,0,154,0,-154
19167,0,0,11,0,-11
19168,1,0,8,0,-8
19169,0,0,3,0,-3
19170,1,1,605,1538,933
19171,1,0,51,0,-51
19172,0,0,21,0,-21
19173,1,1,186,3070,2884
19174,1,1,275,1274,999
19175,0,0,41,0,-41
19176,1,0,58,0,-58
19177,0,0,46,0,-46
19178,1,1,165,1953,1788
19179,1,1,240,1600,1360
19180,0,0,36,0,-36
19181,1,1,1178,1888,710
19182,1,1,1751,1230,-521
19183,1,0,76,0,-76
19184,0,0,102,0,-102
19185,1,0,74,0,-74
19186,0,0,64,0,-64
19187,1,1,353,1319,966
19188,1,0,125,0,-125
19189,1,1,79,1783,1704
19190,0,0,12,0,-12
19191,1,0,19,0,-19
19192,1,0,5,0,-5
19193,1,0,28,0,-28
19194,1,0,18,0,-18
19195,1,1,1645,1446,-199
19196,1,1,1781,1447,-334
19197,0,0,6,0,-6
19198,0,0,9,0,-9
19199,0,0,11,0,-11
19200,0,0,18,0,-18
19201,0,0,69,0,-69
19202,0,0,0,0,0
19203,1,0,269,0,-269
19204,1,0,23,0,-23
19205,1,1,1165,1237,72
19206,1,0,47,0,-47
19207,1,1,780,1237,457
19208,1,1,910,1207,297
19209,1,1,947,1815,868
19210,1,0,24,0,-24
19211,0,0,121,0,-121
19212,1,0,96,0,-96
19213,0,0,41,0,-41
19214,1,0,8,0,-8
19215,0,0,33,0,-33
19216,0,0,70,0,-70
19217,0,0,240,0,-240
19218,1,0,185,0,-185
19219,0,0,8,0,-8
19220,0,0,14,0,-14
19221,0,0,11,0,-11
19222,1,1,415,1268,853
19223,1,1,649,1405,756
19224,0,0,28,0,-28
19225,1,1,278,1305,1027
19226,1,0,108,0,-108
19227,0,0,133,0,-133
19228,1,1,33,1266,1233
19229,1,1,150,1221,1071
19230,1,1,1222,1640,418
19231,1,0,159,0,-159
19232,1,1,1453,2181,728
19233,1,1,407,1747,1340
19234,1,0,6,0,-6
19235,1,1,1102,1781,679
19236,1,1,520,1215,695
19237,1,1,84,1441,1357
19238,1,1,318,1346,1028
19239,0,0,93,0,-93
19240,0,0,22,0,-22
19241,1,0,37,0,-37
19242,0,0,62,0,-62
19243,0,0,83,0,-83
19244,0,0,36,0,-36
19245,0,0,61,0,-61
19246,1,0,20,0,-20
19247,0,0,152,0,-152
19248,1,0,47,0,-47
19249,1,0,20,0,-20
19250,1,1,422,1292,870
19251,1,1,1528,1344,-184
19252,0,0,39,0,-39
19253,1,1,91,1539,1448
19254,1,1,151,1313,1162
19255,1,0,38,0,-38
19256,0,0,65,0,-65
19257,1,1,987,1290,303
19258,1,1,178,1291,1113
19259,0,0,33,0,-33
19260,1,1,1015,2088,1073
19261,1,0,11,0,-11
19262,1,0,60,0,-60
19263,0,0,17,0,-17
19264,0,0,70,0,-70
19265,0,0,73,0,-73
19266,0,0,0,0,0
19267,1,0,22,0,-22
19268,1,0,111,0,-111
19269,0,0,3,0,-3
19270,0,0,42,0,-42
19271,1,0,19,0,-19
19272,1,0,34,0,-34
19273,0,0,16,0,-16
19274,1,1,72,1385,1313
19275,1,1,111,1438,1327
19276,0,0,81,0,-81
19277,0,0,84,0,-84
19278,0,0,3,0,-3
19279,1,1,524,1287,763
19280,1,1,828,1327,499
19281,0,0,29,0,-29
19282,1,0,123,0,-123
19283,1,1,1419,2041,622
19284,0,0,1,0,-1
19285,0,0,13,0,-13
19286,0,0,56,0,-56
19287,1,1,699,1573,874
19288,0,0,293,0,-293
19289,0,0,69,0,-69
19290,1,1,424,1382,958
19291,1,0,88,0,-88
19292,1,0,16,0,-16
19293,0,0,181,0,-181
19294,1,0,9,0,-9
19295,1,0,14,0,-14
19296,1,1,1471,1433,-38
19297,1,1,135,1794,1659
19298,0,0,28,0,-28
19299,0,0,54,0,-54
19300,1,1,506,3098,2592
19301,1,1,702,1291,589
19302,1,0,64,0,-64
19303,1,1,231,1768,1537
19304,0,0,8,0,-8
19305,0,0,4,0,-4
19306,0,0,75,0,-75
19307,1,1,2413,1901,-512
19308,1,1,129,1596,1467
19309,1,1,247,1244,997
19310,1,0,12,0,-12
19311,1,0,4,0,-4
19312,0,0,11,0,-11
19313,0,0,9,0,-9
19314,1,1,47,1523,1476
19315,1,1,13,1204,1191
19316,0,0,62,0,-62
19317,0,0,26,0,-26
19318,0,0,31,0,-31
19319,1,1,543,4694,4151
19320,0,0,12,0,-12
19321,1,1,449,1449,1000
19322,1,0,64,0,-64
19323,0,0,85,0,-85
19324,1,0,41,0,-41
19325,1,0,81,0,-81
19326,1,0,57,0,-57
19327,0,0,136,0,-136
19328,0,0,130,0,-130
19329,1,1,759,1235,476
19330,1,1,566,1263,697
19331,1,0,87,0,-87
19332,1,0,174,0,-174
19333,0,0,90,0,-90
19334,0,0,19,0,-19
19335,1,0,53,0,-53
19336,0,0,30,0,-30
19337,0,0,57,0,-57
19338,0,0,41,0,-41
19339,0,0,4,0,-4
19340,1,1,1701,1211,-490
19341,0,0,21,0,-21
19342,0,0,15,0,-15
19343,0,0,20,0,-20
19344,0,0,138,0,-138
19345,1,1,159,1502,1343
19346,1,0,90,0,-90
19347,0,0,47,0,-47
19348,1,1,922,1353,431
19349,0,0,79,0,-79
19350,1,1,2249,1382,-867
19351,1,1,887,1674,787
19352,1,0,24,0,-24
19353,1,0,45,0,-45
19354,0,0,5,0,-5
19355,1,1,597,1600,1003
19356,1,1,419,1369,950
19357,0,0,67,0,-67
19358,1,0,61,0,-61
19359,1,1,1801,1339,-462
19360,1,1,263,3521,3258
19361,1,1,2565,1225,-1340
19362,1,0,10,0,-10
19363,0,0,42,0,-42
19364,1,0,31,0,-31
19365,0,0,72,0,-72
19366,1,1,458,1214,756
19367,1,1,76,1671,1595
19368,1,1,196,1671,1475
19369,0,0,6,0,-6
19370,0,0,31,0,-31
19371,1,0,107,0,-107
19372,0,0,27,0,-27
19373,1,0,26,0,-26
19374,1,0,141,0,-141
19375,0,0,67,0,-67
19376,1,1,123,1359,1236
19377,1,1,1163,1448,285
19378,1,0,42,0,-42
19379,1,1,319,1216,897
19380,0,0,34,0,-34
19381,1,0,47,0,-47
19382,0,0,18,0,-18
19383,0,0,69,0,-69
19384,1,0,18,0,-18
19385,0,0,15,0,-15
19386,1,1,845,1349,504
19387,0,0,2,0,-2
19388,0,0,249,0,-249
19389,0,0,41,0,-41
19390,0,0,116,0,-116
19391,1,1,584,1376,792
19392,1,0,116,0,-116
19393,1,0,36,0,-36
19394,1,1,583,1511,928
19395,1,1,232,2216,1984
19396,1,1,872,1532,660
19397,0,0,28,0,-28
19398,1,1,227,1949,1722
19399,1,1,123,1489,1366
19400,1,1,347,1304,957
19401,0,0,7,0,-7
19402,0,0,15,0,-15
19403,1,0,40,0,-40
19404,0,0,19,0,-19
19405,1,0,137,0,-137
19406,1,0,0,0,0
19407,0,0,111,0,-111
19408,1,0,27,0,-27
19409,1,0,8,0,-8
19410,1,0,80,0,-80
19411,0,0,2,0,-2
19412,1,1,180,1475,1295
19413,0,0,35,0,-35
19414,1,0,15,0,-15
19415,1,1,740,1373,633
19416,1,1,1162,1476,314
19417,0,0,52,0,-52
19418,0,0,7,0,-7
19419,0,0,100,0,-100
19420,0,0,6,0,-6
19421,1,0,33,0,-33
19422,1,1,261,1208,947
19423,1,1,356,1384,1028
19424,1,1,415,1443,1028
19425,1,0,45,0,-45
19426,0,0,40,0,-40
19427,1,0,6,0,-6
19428,1,0,82,0,-82
19429,1,0,102,0,-102
19430,1,1,144,1820,1676
19431,1,0,0,0,0
19432,0,0,4,0,-4
19433,1,0,0,0,0
19434,1,1,244,1606,1362
19435,0,0,219,0,-219
19436,0,0,53,0,-53
19437,0,0,47,0,-47
19438,0,0,10,0,-10
19439,1,0,6,0,-6
19440,1,0,16,0,-16
19441,1,1,398,1639,1241
19442,1,0,44,0,-44
19443,0,0,12,0,-12
19444,0,0,103,0,-103
19445,0,0,27,0,-27
19446,0,0,172,0,-172
19447,0,0,36,0,-36
19448,0,0,62,0,-62
19449,1,1,211,3317,3106
19450,1,0,46,0,-46
19451,1,1,228,1679,1451
19452,1,0,12,0,-12
19453,0,0,63,0,-63
19454,1,0,18,0,-18
19455,1,1,95,1225,1130
19456,1,1,371,3275,2904
19457,1,1,177,2015,1838
19458,0,0,183,0,-183
19459,0,0,49,0,-49
19460,1,1,1269,1865,596
19461,0,0,13,0,-13
19462,1,0,141,0,-141
19463,1,1,789,1313,524
19464,0,0,15,0,-15
19465,1,0,104,0,-104
19466,0,0,82,0,-82
19467,0,0,72,0,-72
19468,1,1,371,1323,952
19469,1,0,40,0,-40
19470,1,0,38,0,-38
19471,1,1,357,1225,868
19472,1,1,152,1302,1150
19473,0,0,10,0,-10
19474,1,1,272,1283,1011
19475,1,1,1084,1372,288
19476,1,1,886,1426,540
19477,1,1,854,1961,1107
19478,0,0,40,0,-40
19479,0,0,124,0,-124
19480,1,1,250,1506,1256
19481,1,0,0,0,0
19482,0,0,2,0,-2
19483,1,1,1456,1211,-245
19484,0,0,51,0,-51
19485,1,1,218,1265,1047
19486,0,0,71,0,-71
19487,1,0,38,0,-38
19488,1,0,70,0,-70
19489,0,0,10,0,-10
19490,1,0,221,0,-221
19491,1,0,27,0,-27
19492,0,0,137,0,-137
19493,1,1,296,2437,2141
19494,0,0,16,0,-16
19495,1,1,124,1494,1370
19496,1,1,200,2434,2234
19497,0,0,81,0,-81
19498,0,0,15,0,-15
19499,0,0,175,0,-175
19500,0,0,14,0,-14
19501,1,1,2411,2109,-302
19502,1,1,506,2568,2062
19503,0,0,31,0,-31
19504,0,0,29,0,-29
19505,1,0,0,0,0
19506,1,0,72,0,-72
19507,1,1,549,1200,651
19508,1,1,302,1291,989
19509,0,0,54,0,-54
19510,1,1,223,1254,1031
19511,1,1,250,1243,993
19512,0,0,32,0,-32
19513,1,1,466,1220,754
19514,1,1,689,1254,565
19515,1,0,37,0,-37
19516,0,0,5,0,-5
19517,0,0,55,0,-55
19518,1,1,1656,1387,-269
19519,0,0,43,0,-43
19520,0,0,14,0,-14
19521,1,0,25,0,-25
19522,0,0,131,0,-131
19523,0,0,120,0,-120
19524,0,0,9,0,-9
19525,0,0,41,0,-41
19526,0,0,0,0,0
19527,1,0,32,0,-32
19528,1,1,321,1421,1100
19529,0,0,31,0,-31
19530,1,1,28,2077,2049
19531,1,1,1739,1481,-258
19532,0,0,94,0,-94
19533,1,1,463,1339,876
19534,1,1,775,1372,597
19535,0,0,63,0,-63
19536,1,1,442,1500,1058
19537,1,1,720,1207,487
19538,0,0,63,0,-63
19539,1,0,132,0,-132
19540,1,0,0,0,0
19541,1,1,883,1800,917
19542,1,0,67,0,-67
19543,0,0,35,0,-35
19544,1,1,311,2453,2142
19545,0,0,75,0,-75
19546,0,0,85,0,-85
19547,0,0,57,0,-57
19548,0,0,69,0,-69
19549,1,0,41,0,-41
19550,1,1,232,1534,1302
19551,0,0,0,0,0
19552,1,1,393,1572,1179
19553,1,1,510,1399,889
19554,0,0,157,0,-157
19555,0,0,43,0,-43
19556,1,0,11,0,-11
19557,0,0,2,0,-2
19558,0,0,86,0,-86
19559,1,1,544,1636,1092
19560,1,1,532,1352,820
19561,1,0,68,0,-68
19562,1,0,140,0,-140
19563,1,0,16,0,-16
19564,1,0,78,0,-78
19565,1,1,381,1335,954
19566,1,1,699,1253,554
19567,0,0,26,0,-26
19568,0,0,15,0,-15
19569,1,1,259,1632,1373
19570,1,0,38,0,-38
19571,1,0,31,0,-31
19572,1,0,66,0,-66
19573,0,0,58,0,-58
19574,1,0,15,0,-15
19575,0,0,101,0,-101
19576,1,0,51,0,-51
19577,0,0,42,0,-42
19578,1,0,65,0,-65
19579,0,0,31,0,-31
19580,1,1,395,1874,1479
19581,0,0,61,0,-61
19582,1,0,20,0,-20
19583,1,1,444,1439,995
19584,0,0,34,0,-34
19585,0,0,13,0,-13
19586,1,0,19,0,-19
19587,1,1,169,1283,1114
19588,1,0,70,0,-70
19589,1,1,456,1301,845
19590,0,0,53,0,-53
19591,1,0,24,0,-24
19592,1,1,1647,1223,-424
19593,1,1,454,1299,845
19594,1,0,21,0,-21
19595,1,0,26,0,-26
19596,1,1,435,1402,967
19597,1,0,92,0,-92
19598,1,0,11,0,-11
19599,1,0,104,0,-104
19600,0,0,80,0,-80
19601,0,0,77,0,-77
19602,0,0,30,0,-30
19603,0,0,19,0,-19
19604,0,0,4,0,-4
19605,0,0,93,0,-93
19606,0,0,165,0,-165
19607,0,0,2,0,-2
19608,1,0,68,0,-68
19609,0,0,26,0,-26
19610,1,0,175,0,-175
19611,0,0,70,0,-70
19612,1,1,1334,1298,-36
19613,1,0,33,0,-33
19614,0,0,63,0,-63
19615,1,0,2,0,-2
19616,1,1,1137,1564,427
19617,1,1,1935,1232,-703
19618,0,0,29,0,-29
19619,1,0,24,0,-24
19620,1,0,0,0,0
19621,1,0,36,0,-36
19622,1,0,6,0,-6
19623,0,0,98,0,-98
19624,0,0,32,0,-32
19625,0,0,223,0,-223
19626,1,0,22,0,-22
19627,0,0,50,0,-50
19628,1,1,649,1596,947
19629,1,1,126,1413,1287
19630,0,0,16,0,-16
19631,1,1,1300,1528,228
19632,1,1,972,1386,414
19633,1,1,1849,1236,-613
19634,0,0,42,0,-42
19635,1,1,327,1476,1149
19636,0,0,0,0,0
19637,0,0,13,0,-13
19638,1,1,398,1383,985
19639,1,0,24,0,-24
19640,1,0,57,0,-57
19641,0,0,82,0,-82
19642,0,0,19,0,-19
19643,1,0,27,0,-27
19644,0,0,55,0,-55
19645,1,1,501,1682,1181
19646,1,1,75,1492,1417
19647,0,0,1,0,-1
19648,1,1,1108,1229,121
19649,1,0,59,0,-59
19650,1,0,76,0,-76
19651,1,0,5,0,-5
19652,0,0,7,0,-7
19653,1,0,42,0,-42
19654,0,0,33,0,-33
19655,0,0,79,0,-79
19656,0,0,26,0,-26
19657,0,0,170,0,-170
19658,1,0,20,0,-20
19659,0,0,115,0,-115
19660,0,0,64,0,-64
19661,0,0,64,0,-64
19662,0,0,10,0,-10
19663,1,0,95,0,-95
19664,0,0,22,0,-22
19665,1,0,51,0,-51
19666,0,0,10,0,-10
19667,1,1,69,1731,1662
19668,1,1,578,1333,755
19669,1,1,1228,1384,156
19670,1,0,20,0,-20
19671,1,1,958,1451,493
19672,0,0,54,0,-54
19673,0,0,11,0,-11
19674,0,0,80,0,-80
19675,1,0,25,0,-25
19676,0,0,17,0,-17
19677,1,1,940,2332,1392
19678,0,0,70,0,-70
19679,1,1,608,1442,834
19680,0,0,81,0,-81
19681,1,0,4,0,-4
19682,1,1,437,1218,781
19683,1,0,70,0,-70
19684,0,0,19,0,-19
19685,0,0,25,0,-25
19686,0,0,20,0,-20
19687,1,0,15,0,-15
19688,0,0,31,0,-31
19689,0,0,42,0,-42
19690,1,1,246,2124,1878
19691,1,1,1764,1360,-404
19692,1,1,202,1423,1221
19693,0,0,92,0,-92
19694,1,1,282,1277,995
19695,1,0,13,0,-13
19696,1,0,120,0,-120
19697,0,0,56,0,-56
19698,1,1,190,1950,1760
19699,1,0,1,0,-1
19700,1,1,178,1409,1231
19701,1,0,79,0,-79
19702,1,1,359,1242,883
19703,1,1,219,1219,1000
19704,1,1,668,1247,579
19705,1,1,545,1755,1210
19706,0,0,59,0,-59
19707,1,1,182,1622,1440
19708,0,0,75,0,-75
19709,0,0,88,0,-88
19710,1,0,91,0,-91
19711,0,0,48,0,-48
19712,1,1,1092,2561,1469
19713,0,0,68,0,-68
19714,0,0,96,0,-96
19715,1,1,133,1260,1127
19716,0,0,18,0,-18
19717,0,0,77,0,-77
19718,0,0,15,0,-15
19719,0,0,76,0,-76
19720,0,0,18,0,-18
19721,1,0,79,0,-79
19722,1,1,649,1347,698
19723,1,0,52,0,-52
19724,1,0,17,0,-17
19725,1,0,32,0,-32
19726,1,0,17,0,-17
19727,0,0,39,0,-39
19728,0,0,16,0,-16
19729,1,1,120,1772,1652
19730,1,0,19,0,-19
19731,1,1,5,1357,1352
19732,0,0,30,0,-30
19733,0,0,39,0,-39
19734,0,0,130,0,-130
19735,1,1,337,1258,921
19736,0,0,64,0,-64
19737,1,1,748,1230,482
19738,0,0,61,0,-61
19739,1,1,124,1926,1802
19740,0,0,61,0,-61
19741,1,0,34,0,-34
19742,0,0,46,0,-46
19743,0,0,84,0,-84
19744,0,0,6,0,-6
19745,0,0,63,0,-63
19746,0,0,107,0,-107
19747,0,0,24,0,-24
19748,1,0,2,0,-2
19749,0,0,80,0,-80
19750,1,0,10,0,-10
19751,1,1,151,4559,4408
19752,0,0,42,0,-42
19753,1,1,514,1465,951
19754,1,1,104,1347,1243
19755,1,1,140,1344,1204
19756,0,0,1,0,-1
19757,1,0,16,0,-16
19758,0,0,114,0,-114
19759,1,1,2018,1331,-687
19760,0,0,38,0,-38
19761,1,1,19,1346,1327
19762,1,0,50,0,-50
19763,1,1,90,2189,2099
19764,0,0,126,0,-126
19765,0,0,19,0,-19
19766,0,0,35,0,-35
19767,1,1,557,1365,808
19768,1,0,54,0,-54
19769,1,1,357,1358,1001
19770,1,1,155,1603,1448
19771,0,0,53,0,-53
19772,0,0,37,0,-37
19773,1,0,29,0,-29
19774,0,0,25,0,-25
19775,1,1,429,1721,1292
19776,0,0,31,0,-31
19777,0,0,1,0,-1
19778,1,0,40,0,-40
19779,1,0,35,0,-35
19780,1,1,697,2196,1499
19781,1,0,87,0,-87
19782,1,1,143,1355,1212
19783,0,0,38,0,-38
19784,1,0,4,0,-4
19785,1,1,381,1524,1143
19786,0,0,19,0,-19
19787,1,0,33,0,-33
19788,1,0,10,0,-10
19789,0,0,8,0,-8
19790,1,1,545,2255,1710
19791,1,1,1086,1494,408
19792,1,0,36,0,-36
19793,1,0,28,0,-28
19794,1,1,1004,1228,224
19795,1,1,425,1297,872
19796,0,0,109,0,-109
19797,1,0,80,0,-80
19798,1,0,39,0,-39
19799,1,1,342,1230,888
19800,0,0,28,0,-28
19801,0,0,123,0,-123
19802,1,0,6,0,-6
19803,0,0,17,0,-17
19804,1,0,38,0,-38
19805,0,0,44,0,-44
19806,1,1,113,1463,1350
19807,1,1,1054,1746,692
19808,0,0,27,0,-27
19809,1,1,1594,1547,-47
19810,0,0,75,0,-75
19811,1,0,66,0,-66
19812,0,0,14,0,-14
19813,0,0,102,0,-102
19814,1,0,112,0,-112
19815,0,0,33,0,-33
19816,0,0,104,0,-104
19817,1,1,160,1286,1126
19818,1,1,154,1245,1091
19819,1,1,454,1227,773
19820,1,1,466,1311,845
19821,1,0,22,0,-22
19822,0,0,28,0,-28
19823,0,0,163,0,-163
19824,1,1,189,1716,1527
19825,1,1,1750,1905,155
19826,1,0,18,0,-18
19827,1,0,27,0,-27
19828,1,1,77,4918,4841
19829,1,1,449,1277,828
19830,1,0,68,0,-68
19831,1,1,967,1684,717
19832,0,0,4,0,-4
19833,1,0,13,0,-13
19834,1,1,299,1655,1356
19835,0,0,42,0,-42
19836,1,1,94,1392,1298
19837,0,0,7,0,-7
19838,0,0,31,0,-31
19839,1,1,1005,1495,490
19840,1,1,352,1317,965
19841,1,0,341,0,-341
19842,1,1,539,1332,793
19843,1,0,4,0,-4
19844,1,1,182,1253,1071
19845,1,1,328,1744,1416
19846,1,0,112,0,-112
19847,1,0,19,0,-19
19848,1,0,5,0,-5
19849,1,0,20,0,-20
19850,1,0,43,0,-43
19851,0,0,12,0,-12
19852,0,0,57,0,-57
19853,0,0,20,0,-20
19854,1,0,33,0,-33
19855,0,0,5,0,-5
19856,0,0,10,0,-10
19857,1,0,25,0,-25
19858,1,1,614,1421,807
19859,1,1,213,1359,1146
19860,1,0,16,0,-16
19861,1,1,330,1464,1134
19862,1,0,17,0,-17
19863,1,1,307,1523,1216
19864,0,0,16,0,-16
19865,1,0,7,0,-7
19866,0,0,162,0,-162
19867,0,0,30,0,-30
19868,1,0,179,0,-179
19869,1,0,16,0,-16
19870,1,0,20,0,-20
19871,1,1,292,1650,1358
19872,0,0,2,0,-2
19873,1,1,518,1325,807
19874,1,1,355,1580,1225
19875,1,0,20,0,-20
19876,1,1,1170,3025,1855
19877,0,0,26,0,-26
19878,1,0,4,0,-4
19879,1,1,308,1565,1257
19880,1,0,134,0,-134
19881,0,0,79,0,-79
19882,0,0,9,0,-9
19883,0,0,18,0,-18
19884,1,1,870,1201,331
19885,1,0,1,0,-1
19886,1,1,378,1906,1528
19887,1,1,394,1907,1513
19888,0,0,85,0,-85
19889,0,0,35,0,-35
19890,0,0,24,0,-24
19891,1,0,2,0,-2
19892,1,0,26,0,-26
19893,1,1,52,1292,1240
19894,0,0,116,0,-116
19895,1,1,635,3324,2689
19896,0,0,23,0,-23
19897,1,1,322,1231,909
19898,0,0,4,0,-4
19899,0,0,12,0,-12
19900,1,0,5,0,-5
19901,0,0,24,0,-24
19902,0,0,115,0,-115
19903,1,1,57,1948,1891
19904,0,0,0,0,0
19905,1,0,176,0,-176
19906,1,0,110,0,-110
19907,1,0,31,0,-31
19908,1,1,98,1277,1179
19909,1,0,29,0,-29
19910,0,0,246,0,-246
19911,0,0,146,0,-146
19912,0,0,108,0,-108
19913,0,0,102,0,-102
19914,0,0,207,0,-207
19915,0,0,13,0,-13
19916,0,0,73,0,-73
19917,0,0,0,0,0
19918,1,0,14,0,-14
19919,0,0,21,0,-21
19920,1,0,32,0,-32
19921,0,0,203,0,-203
19922,0,0,18,0,-18
19923,1,0,39,0,-39
19924,0,0,72,0,-72
19925,1,1,715,1601,886
19926,0,0,25,0,-25
19927,1,1,95,3578,3483
19928,0,0,149,0,-149
19929,1,1,939,1266,327
19930,1,0,52,0,-52
19931,1,1,234,1242,1008
19932,0,0,47,0,-47
19933,1,1,220,1439,1219
19934,0,0,249,0,-249
19935,1,1,427,4132,3705
19936,1,0,15,0,-15
19937,0,0,15,0,-15
19938,0,0,20,0,-20
19939,0,0,218,0,-218
19940,1,1,63,1464,1401
19941,0,0,26,0,-26
19942,1,1,600,1805,1205
19943,1,1,857,1280,423
19944,0,0,170,0,-170
19945,1,1,65,1555,1490
19946,1,1,74,1226,1152
19947,1,1,2021,1399,-622
19948,1,1,1590,1493,-97
19949,0,0,0,0,0
19950,1,1,320,1361,1041
19951,1,0,1,0,-1
19952,0,0,63,0,-63
19953,0,0,7,0,-7
19954,1,1,995,1519,524
19955,0,0,5,0,-5
19956,1,1,710,1320,610
19957,1,0,54,0,-54
19958,1,1,850,2885,2035
19959,0,0,3,0,-3
19960,1,0,16,0,-16
19961,1,1,134,1368,1234
19962,1,1,285,1220,935
19963,1,1,933,1810,877
19964,1,1,719,1656,937
19965,0,0,34,0,-34
19966,0,0,149,0,-149
19967,0,0,44,0,-44
19968,1,0,7,0,-7
19969,1,0,0,0,0
19970,1,1,161,1224,1063
19971,0,0,45,0,-45
19972,0,0,58,0,-58
19973,1,0,105,0,-105
19974,1,0,33,0,-33
19975,0,0,96,0,-96
19976,1,0,55,0,-55
19977,0,0,79,0,-79
19978,1,1,513,2111,1598
19979,1,1,1311,1418,107
19980,1,0,55,0,-55
19981,1,0,18,0,-18
19982,1,0,48,0,-48
19983,0,0,115,0,-115
19984,0,0,33,0,-33
19985,1,1,465,1562,1097
19986,0,0,3,0,-3
19987,1,1,124,1253,1129
19988,0,0,27,0,-27
19989,1,1,58,2337,2279
19990,1,0,96,0,-96
19991,1,0,32,0,-32
19992,0,0,24,0,-24
19993,1,1,786,1247,461
19994,1,0,46,0,-46
19995,1,0,112,0,-112
19996,1,1,149,1336,1187
19997,0,0,21,0,-21
19998,1,1,195,1221,1026
19999,0,0,12,0,-12
20000,1,0,12,0,-12
20001,0,0,103,0,-103
20002,0,0,148,0,-148
20003,1,0,50,0,-50
20004,1,1,458,1215,757
20005,0,0,19,0,-19
20006,1,1,564,1567,1003
20007,1,1,773,1779,1006
20008,1,0,21,0,-21
20009,1,0,13,0,-13
20010,1,1,744,1389,645
20011,0,0,4,0,-4
20012,0,0,73,0,-73
20013,0,0,48,0,-48
20014,1,0,57,0,-57
20015,1,1,104,1251,1147
20016,0,0,73,0,-73
20017,1,1,337,1398,1061
20018,0,0,35,0,-35
20019,1,0,16,0,-16
20020,1,1,1159,1817,658
20021,0,0,54,0,-54
20022,0,0,122,0,-122
20023,0,0,112,0,-112
20024,0,0,3,0,-3
20025,1,0,14,0,-14
20026,1,1,423,1571,1148
20027,0,0,55,0,-55
20028,1,0,30,0,-30
20029,1,0,178,0,-178
20030,0,0,8,0,-8
20031,0,0,33,0,-33
20032,1,1,553,1207,654
20033,1,0,51,0,-51
20034,1,1,53,2165,2112
20035,1,0,47,0,-47
20036,1,1,182,1316,1134
20037,0,0,86,0,-86
20038,1,1,528,1264,736
20039,1,1,339,1231,892
20040,0,0,91,0,-91
20041,1,0,116,0,-116
20042,0,0,51,0,-51
20043,0,0,47,0,-47
20044,1,1,105,1378,1273
20045,1,0,17,0,-17
20046,0,0,8,0,-8
20047,0,0,23,0,-23
20048,0,0,90,0,-90
20049,1,1,907,2210,1303
20050,0,0,6,0,-6
20051,1,0,36,0,-36
20052,0,0,5,0,-5
20053,1,0,12,0,-12
20054,1,1,841,1620,779
20055,1,0,153,0,-153
20056,1,0,64,0,-64
20057,1,1,164,1550,1386
20058,0,0,42,0,-42
20059,0,0,10,0,-10
20060,0,0,43,0,-43
20061,1,0,14,0,-14
20062,1,1,383,1241,858
20063,0,0,70,0,-70
20064,0,0,43,0,-43
20065,0,0,81,0,-81
20066,1,0,292,0,-292
20067,0,0,88,0,-88
20068,0,0,74,0,-74
20069,0,0,14,0,-14
20070,0,0,20,0,-20
20071,1,1,157,1259,1102
20072,1,0,41,0,-41
20073,1,0,3,0,-3
20074,1,0,14,0,-14
20075,1,1,555,1328,773
20076,0,0,4,0,-4
20077,1,0,31,0,-31
20078,0,0,22,0,-22
20079,1,1,222,1525,1303
20080,0,0,75,0,-75
20081,1,1,64,1358,1294
20082,0,0,32,0,-32
20083,1,0,1,0,-1
20084,1,1,26,1317,1291
20085,1,0,73,0,-73
20086,0,0,4,0,-4
20087,0,0,10,0,-10
20088,0,0,0,0,0
20089,1,0,4,0,-4
20090,1,0,138,0,-138
20091,0,0,89,0,-89
20092,1,1,1634,1302,-332
20093,1,1,300,1289,989
20094,0,0,113,0,-113
20095,0,0,74,0,-74
20096,1,1,736,2009,1273
20097,0,0,45,0,-45
20098,0,0,35,0,-35
20099,0,0,2,0,-2
20100,0,0,7,0,-7
20101,1,0,10,0,-10
20102,1,1,927,1300,373
20103,1,0,67,0,-67
20104,0,0,55,0,-55
20105,1,1,249,1314,1065
20106,1,1,550,1250,700
20107,1,1,126,1213,1087
20108,1,1,1091,2050,959
20109,1,0,15,0,-15
20110,0,0,12,0,-12
20111,0,0,11,0,-11
20112,0,0,19,0,-19
20113,1,1,31,1525,1494
20114,1,1,1024,1237,213
20115,1,1,575,1259,684
20116,1,1,36,2052,2016
20117,1,0,20,0,-20
20118,1,1,842,1435,593
20119,1,0,3,0,-3
20120,1,1,163,1449,1286
20121,0,0,58,0,-58
20122,1,0,94,0,-94
20123,1,0,155,0,-155
20124,0,0,64,0,-64
20125,1,0,1,0,-1
20126,1,1,310,1849,1539
20127,0,0,2,0,-2
20128,1,0,238,0,-238
20129,1,1,1337,1532,195
20130,1,1,409,1912,1503
20131,0,0,38,0,-38
20132,1,0,161,0,-161
20133,0,0,45,0,-45
20134,1,0,85,0,-85
20135,1,1,127,1239,1112
20136,1,1,554,1890,1336
20137,1,1,757,1507,750
20138,1,0,44,0,-44
20139,0,0,34,0,-34
20140,1,0,11,0,-11
20141,1,0,8,0,-8
20142,1,1,516,1423,907
20143,1,1,296,1200,904
20144,1,0,12,0,-12
20145,1,1,277,1798,1521
20146,0,0,31,0,-31
20147,1,0,17,0,-17
20148,0,0,15,0,-15
20149,1,1,219,1760,1541
20150,1,1,314,1473,1159
20151,0,0,13,0,-13
20152,0,0,76,0,-76
20153,1,1,346,1373,1027
20154,1,1,304,1292,988
20155,1,0,84,0,-84
20156,1,0,20,0,-20
20157,0,0,112,0,-112
20158,1,1,2893,1270,-1623
20159,0,0,121,0,-121
20160,1,1,701,1743,1042
20161,1,1,583,1284,701
20162,1,0,35,0,-35
20163,0,0,37,0,-37
20164,1,1,178,1870,1692
20165,0,0,14,0,-14
20166,0,0,4,0,-4
20167,0,0,42,0,-42
20168,1,1,1442,1430,-12
20169,0,0,5,0,-5
20170,0,0,26,0,-26
20171,0,0,194,0,-194
20172,0,0,137,0,-137
20173,1,1,2857,1399,-1458
20174,0,0,54,0,-54
20175,1,1,127,1529,1402
20176,1,0,14,0,-14
20177,1,1,274,1278,1004
20178,1,1,701,3120,2419
20179,0,0,10,0,-10
20180,1,0,108,0,-108
20181,1,0,16,0,-16
20182,0,0,58,0,-58
20183,1,1,309,1428,1119
20184,0,0,91,0,-91
20185,1,1,278,2421,2143
20186,0,0,0,0,0
20187,1,1,679,1514,835
20188,0,0,62,0,-62
20189,0,0,130,0,-130
20190,0,0,81,0,-81
20191,1,0,19,0,-19
20192,1,0,63,0,-63
20193,1,0,57,0,-57
20194,1,1,450,1595,1145
20195,0,0,64,0,-64
20196,0,0,65,0,-65
20197,1,0,54,0,-54
20198,0,0,56,0,-56
20199,1,0,6,0,-6
20200,1,1,272,2159,1887
20201,0,0,81,0,-81
20202,1,0,93,0,-93
20203,1,0,39,0,-39
20204,1,0,61,0,-61
20205,0,0,5,0,-5
20206,1,1,213,2284,2071
20207,1,0,87,0,-87
20208,1,1,704,1220,516
20209,1,0,76,0,-76
20210,1,0,83,0,-83
20211,0,0,45,0,-45
20212,1,1,1222,1944,722
20213,1,0,148,0,-148
20214,1,0,61,0,-61
20215,1,1,315,1751,1436
20216,1,0,16,0,-16
20217,0,0,197,0,-197
20218,1,0,104,0,-104
20219,1,0,24,0,-24
20220,1,0,12,0,-12
20221,1,1,294,3929,3635
20222,1,1,235,1893,1658
20223,0,0,4,0,-4
20224,0,0,17,0,-17
20225,1,1,991,1228,237
20226,1,1,87,1256,1169
20227,1,0,72,0,-72
20228,1,1,148,1747,1599
20229,1,1,768,1251,483
20230,0,0,25,0,-25
20231,1,1,572,1322,750
20232,1,1,1307,1291,-16
20233,1,0,107,0,-107
20234,1,1,239,1743,1504
20235,1,1,130,1358,1228
20236,0,0,71,0,-71
20237,1,0,36,0,-36
20238,1,1,822,2428,1606
20239,0,0,1,0,-1
20240,1,0,3,0,-3
20241,1,1,95,2019,1924
20242,1,0,20,0,-20
20243,1,1,137,2551,2414
20244,0,0,224,0,-224
20245,0,0,17,0,-17
20246,0,0,7,0,-7
20247,1,1,2598,4464,1866
20248,0,0,4,0,-4
20249,1,1,416,1901,1485
20250,0,0,206,0,-206
20251,1,0,14,0,-14
20252,1,1,1672,1774,102
20253,1,1,423,1350,927
20254,1,0,132,0,-132
20255,0,0,9,0,-9
20256,0,0,39,0,-39
20257,0,0,23,0,-23
20258,1,1,85,1909,1824
20259,0,0,71,0,-71
20260,1,1,583,1205,622
20261,1,1,680,1679,999
20262,0,0,48,0,-48
20263,1,1,184,1423,1239
20264,0,0,77,0,-77
20265,1,1,248,1353,1105
20266,0,0,48,0,-48
20267,0,0,1,0,-1
20268,1,0,6,0,-6
20269,1,1,1089,2220,1131
20270,1,1,465,1551,1086
20271,1,0,1,0,-1
20272,0,0,35,0,-35
20273,1,1,464,1457,993
20274,1,1,25,1566,1541
20275,1,1,892,1687,795
20276,1,1,883,2082,1199
20277,0,0,22,0,-22
20278,1,1,97,1243,1146
20279,0,0,16,0,-16
20280,0,0,3,0,-3
20281,0,0,4,0,-4
20282,0,0,242,0,-242
20283,1,0,9,0,-9
20284,0,0,2,0,-2
20285,0,0,0,0,0
20286,0,0,29,0,-29
20287,0,0,39,0,-39
20288,0,0,97,0,-97
20289,1,0,40,0,-40
20290,1,1,759,1284,525
20291,1,1,447,1252,805
20292,0,0,211,0,-211
20293,0,0,87,0,-87
20294,1,1,618,1309,691
20295,1,1,45,1283,1238
20296,1,0,8,0,-8
20297,1,1,21,1246,1225
20298,1,1,260,1244,984
20299,1,0,24,0,-24
20300,0,0,54,0,-54
20301,0,0,22,0,-22
20302,0,0,50,0,-50
20303,0,0,69,0,-69
20304,0,0,31,0,-31
20305,0,0,4,0,-4
20306,1,0,11,0,-11
20307,1,0,29,0,-29
20308,0,0,22,0,-22
20309,0,0,40,0,-40
20310,1,1,419,1222,803
20311,1,0,61,0,-61
20312,1,1,932,1513,581
20313,0,0,19,0,-19
20314,1,0,75,0,-75
20315,1,0,29,0,-29
20316,1,1,796,1745,949
20317,0,0,44,0,-44
20318,1,0,55,0,-55
20319,1,1,806,1567,761
20320,1,0,28,0,-28
20321,1,0,84,0,-84
20322,1,0,9,0,-9
20323,1,0,1,0,-1
20324,1,1,373,1507,1134
20325,1,0,34,0,-34
20326,0,0,59,0,-59
20327,0,0,15,0,-15
20328,1,1,160,1211,1051
20329,1,1,1585,1211,-374
20330,0,0,2,0,-2
20331,1,0,18,0,-18
20332,0,0,31,0,-31
20333,0,0,24,0,-24
20334,0,0,28,0,-28
20335,0,0,43,0,-43
20336,0,0,33,0,-33
20337,1,0,122,0,-122
20338,1,1,529,1336,807
20339,1,0,0,0,0
20340,0,0,2,0,-2
20341,0,0,162,0,-162
20342,1,0,91,0,-91
20343,0,0,5,0,-5
20344,0,0,73,0,-73
20345,0,0,40,0,-40
20346,1,0,142,0,-142
20347,1,1,788,1509,721
20348,1,0,34,0,-34
20349,1,1,775,1557,782
20350,0,0,56,0,-56
20351,0,0,0,0,0
20352,1,1,263,1251,988
20353,0,0,50,0,-50
20354,0,0,51,0,-51
20355,0,0,178,0,-178
20356,0,0,8,0,-8
20357,1,0,238,0,-238
20358,0,0,28,0,-28
20359,1,1,158,1813,1655
20360,1,1,337,1304,967
20361,1,0,84,0,-84
20362,1,0,11,0,-11
20363,0,0,28,0,-28
20364,0,0,95,0,-95
20365,1,1,422,1280,858
20366,0,0,159,0,-159
20367,1,1,601,1357,756
20368,1,1,104,1250,1146
20369,0,0,18,0,-18
20370,1,0,3,0,-3
20371,0,0,41,0,-41
20372,0,0,6,0,-6
20373,1,0,3,0,-3
20374,0,0,106,0,-106
20375,0,0,38,0,-38
20376,1,1,227,2142,1915
20377,1,0,54,0,-54
20378,1,0,53,0,-53
20379,1,0,14,0,-14
20380,1,0,106,0,-106
20381,0,0,68,0,-68
20382,0,0,63,0,-63
20383,1,1,604,1232,628
20384,1,1,71,1426,1355
20385,1,1,292,4579,4287
20386,1,0,46,0,-46
20387,1,0,32,0,-32
20388,0,0,8,0,-8
20389,1,0,158,0,-158
20390,0,0,34,0,-34
20391,0,0,28,0,-28
20392,1,0,24,0,-24
20393,1,0,50,0,-50
20394,1,0,6,0,-6
20395,1,0,8,0,-8
20396,0,0,20,0,-20
20397,1,0,3,0,-3
20398,0,0,78,0,-78
20399,0,0,41,0,-41
20400,1,0,70,0,-70
20401,1,1,62,1781,1719
20402,0,0,28,0,-28
20403,0,0,5,0,-5
20404,0,0,58,0,-58
20405,1,0,85,0,-85
20406,1,1,540,1244,704
20407,1,0,45,0,-45
20408,1,1,245,1472,1227
20409,1,1,1011,1220,209
20410,1,1,184,4212,4028
20411,1,0,3,0,-3
20412,1,1,425,1360,935
20413,1,0,32,0,-32
20414,1,0,27,0,-27
20415,0,0,13,0,-13
20416,0,0,39,0,-39
20417,0,0,7,0,-7
20418,1,1,235,3016,2781
20419,0,0,109,0,-109
20420,1,1,862,1337,475
20421,1,1,399,1463,1064
20422,0,0,115,0,-115
20423,1,0,9,0,-9
20424,0,0,28,0,-28
20425,1,0,16,0,-16
20426,1,1,19,1291,1272
20427,0,0,35,0,-35
20428,0,0,228,0,-228
20429,1,1,1224,1318,94
20430,1,0,33,0,-33
20431,0,0,91,0,-91
20432,0,0,7,0,-7
20433,1,0,45,0,-45
20434,0,0,192,0,-192
20435,1,0,9,0,-9
20436,0,0,15,0,-15
20437,1,1,1168,1402,234
20438,0,0,45,0,-45
20439,1,1,356,2052,1696
20440,0,0,69,0,-69
20441,1,0,133,0,-133
20442,1,0,90,0,-90
20443,1,1,117,1542,1425
20444,1,0,16,0,-16
20445,1,1,524,1378,854
20446,1,0,13,0,-13
20447,1,0,19,0,-19
20448,1,1,965,1248,283
20449,1,0,21,0,-21
20450,1,1,275,1299,1024
20451,0,0,17,0,-17
20452,0,0,57,0,-57
20453,1,0,63,0,-63
20454,1,1,88,1300,1212
20455,0,0,27,0,-27
20456,1,1,385,1222,837
20457,0,0,25,0,-25
20458,1,0,32,0,-32
20459,1,1,811,1641,830
20460,0,0,99,0,-99
20461,1,1,34,1260,1226
20462,1,1,309,1347,1038
20463,0,0,94,0,-94
20464,1,0,186,0,-186
20465,1,0,53,0,-53
20466,1,0,14,0,-14
20467,1,0,91,0,-91
20468,1,1,452,1469,1017
20469,1,1,488,1335,847
20470,0,0,71,0,-71
20471,1,0,108,0,-108
20472,1,0,104,0,-104
20473,0,0,13,0,-13
20474,1,1,152,1894,1742
20475,0,0,111,0,-111
20476,0,0,9,0,-9
20477,0,0,36,0,-36
20478,0,0,38,0,-38
20479,0,0,13,0,-13
20480,1,1,285,1291,1006
20481,1,1,920,1271,351
20482,0,0,73,0,-73
20483,0,0,13,0,-13
20484,1,0,18,0,-18
20485,0,0,19,0,-19
20486,0,0,20,0,-20
20487,1,1,135,2176,2041
20488,1,1,337,1287,950
20489,1,1,430,1496,1066
20490,1,0,122,0,-122
20491,1,1,301,1471,1170
20492,1,0,3,0,-3
20493,1,1,425,1766,1341
20494,1,1,718,1530,812
20495,1,1,274,1584,1310
20496,1,0,1,0,-1
20497,0,0,27,0,-27
20498,1,1,751,1324,573
20499,1,1,630,1226,596
20500,1,1,784,1489,705
20501,1,1,1452,2620,1168
20502,0,0,19,0,-19
20503,0,0,15,0,-15
20504,0,0,0,0,0
20505,1,1,200,1298,1098
20506,1,1,214,1744,1530
20507,1,0,12,0,-12
20508,0,0,47,0,-47
20509,1,0,13,0,-13
20510,0,0,5,0,-5
20511,1,1,355,1361,1006
20512,1,1,110,1378,1268
20513,1,0,151,0,-151
20514,1,0,2,0,-2
20515,0,0,16,0,-16
20516,0,0,8,0,-8
20517,1,0,19,0,-19
20518,1,1,520,1541,1021
20519,1,1,913,1351,438
20520,1,1,351,1474,1123
20521,0,0,46,0,-46
20522,1,1,942,1219,277
20523,0,0,63,0,-63
20524,0,0,76,0,-76
20525,1,1,415,1446,1031
20526,1,1,304,4649,4345
20527,1,0,21,0,-21
20528,0,0,42,0,-42
20529,1,0,4,0,-4
20530,1,0,19,0,-19
20531,0,0,66,0,-66
20532,0,0,18,0,-18
20533,0,0,47,0,-47
20534,0,0,29,0,-29
20535,1,1,350,1514,1164
20536,1,0,17,0,-17
20537,1,0,19,0,-19
20538,1,1,215,2200,1985
20539,1,0,5,0,-5
20540,1,1,433,1697,1264
20541,1,0,86,0,-86
20542,0,0,1,0,-1
20543,0,0,65,0,-65
20544,1,1,793,1834,1041
20545,1,1,248,1333,1085
20546,0,0,4,0,-4
20547,0,0,27,0,-27
20548,0,0,17,0,-17
20549,0,0,13,0,-13
20550,0,0,156,0,-156
20551,1,0,52,0,-52
20552,1,1,201,1372,1171
20553,1,0,49,0,-49
20554,1,1,106,1414,1308
20555,0,0,56,0,-56
20556,1,0,56,0,-56
20557,1,1,263,1220,957
20558,0,0,96,0,-96
20559,1,1,731,1311,580
20560,1,0,105,0,-105
20561,1,1,568,1212,644
20562,1,0,37,0,-37
20563,1,1,440,1563,1123
20564,0,0,5,0,-5
20565,1,1,2029,1256,-773
20566,0,0,6,0,-6
20567,1,0,13,0,-13
20568,0,0,12,0,-12
20569,1,0,4,0,-4
20570,1,1,257,1609,1352
20571,1,0,45,0,-45
20572,1,0,4,0,-4
20573,1,1,186,1242,1056
20574,0,0,64,0,-64
20575,1,0,23,0,-23
20576,1,0,104,0,-104
20577,0,0,34,0,-34
20578,1,0,74,0,-74
20579,1,0,6,0,-6
20580,1,1,393,1776,1383
20581,0,0,54,0,-54
20582,1,0,50,0,-50
20583,0,0,1,0,-1
20584,0,0,106,0,-106
20585,1,1,813,1343,530
20586,1,1,374,1606,1232
20587,1,1,243,1696,1453
20588,0,0,36,0,-36
20589,0,0,7,0,-7
20590,1,1,258,5492,5234
20591,0,0,4,0,-4
20592,1,1,345,2304,1959
20593,1,0,56,0,-56
20594,1,0,44,0,-44
20595,0,0,17,0,-17
20596,1,1,192,1336,1144
20597,1,0,47,0,-47
20598,0,0,35,0,-35
20599,1,1,1594,1403,-191
20600,0,0,36,0,-36
20601,1,1,283,1250,967
20602,1,1,551,1202,651
20603,1,0,16,0,-16
20604,0,0,138,0,-138
20605,0,0,31,0,-31
20606,1,1,346,1238,892
20607,0,0,12,0,-12
20608,0,0,30,0,-30
20609,1,0,70,0,-70
20610,0,0,48,0,-48
20611,1,0,61,0,-61
20612,1,0,95,0,-95
20613,1,0,1,0,-1
20614,1,0,15,0,-15
20615,1,1,1395,2316,921
20616,1,1,599,1236,637
20617,1,0,109,0,-109
20618,1,1,4114,1973,-2141
20619,1,0,51,0,-51
20620,0,0,69,0,-69
20621,1,1,334,1226,892
20622,0,0,1,0,-1
20623,1,0,36,0,-36
20624,1,0,0,0,0
20625,1,1,788,1434,646
20626,1,0,11,0,-11
20627,1,0,117,0,-117
20628,0,0,29,0,-29
20629,0,0,12,0,-12
20630,1,1,987,1288,301
20631,1,1,494,1307,813
20632,0,0,125,0,-125
20633,1,1,438,2516,2078
20634,0,0,66,0,-66
20635,0,0,63,0,-63
20636,1,1,407,1340,933
20637,0,0,32,0,-32
20638,1,1,509,1563,1054
20639,0,0,37,0,-37
20640,1,0,85,0,-85
20641,1,0,14,0,-14
20642,1,0,73,0,-73
20643,1,1,521,1508,987
20644,0,0,63,0,-63
20645,1,1,542,1286,744
20646,1,1,274,1205,931
20647,0,0,133,0,-133
20648,0,0,65,0,-65
20649,1,0,71,0,-71
20650,1,1,65,1572,1507
20651,1,0,132,0,-132
20652,0,0,19,0,-19
20653,1,0,33,0,-33
20654,0,0,9,0,-9
20655,1,1,1281,1923,642
20656,1,0,12,0,-12
20657,1,1,672,1231,559
20658,0,0,14,0,-14
20659,1,1,255,1472,1217
20660,0,0,20,0,-20
20661,0,0,1,0,-1
20662,1,1,307,1932,1625
20663,1,1,1600,1428,-172
20664,0,0,77,0,-77
20665,0,0,10,0,-10
20666,1,1,1272,2593,1321
20667,1,0,10,0,-10
20668,0,0,4,0,-4
20669,1,0,8,0,-8
20670,1,0,90,0,-90
20671,1,1,689,1488,799
20672,1,0,1,0,-1
20673,0,0,149,0,-149
20674,1,0,1,0,-1
20675,1,0,100,0,-100
20676,0,0,130,0,-130
20677,1,1,488,1695,1207
20678,1,1,95,1238,1143
20679,1,0,141,0,-141
20680,1,1,87,2094,2007
20681,1,0,71,0,-71
20682,1,0,46,0,-46
20683,0,0,14,0,-14
20684,1,0,99,0,-99
20685,0,0,7,0,-7
20686,1,1,106,1432,1326
20687,1,1,197,1328,1131
20688,0,0,14,0,-14
20689,1,0,12,0,-12
20690,1,1,103,1506,1403
20691,1,1,891,1513,622
20692,0,0,16,0,-16
20693,0,0,11,0,-11
20694,1,0,13,0,-13
20695,0,0,17,0,-17
20696,0,0,43,0,-43
20697,1,0,29,0,-29
20698,1,1,634,1270,636
20699,1,1,91,1725,1634
20700,1,0,43,0,-43
20701,1,0,63,0,-63
20702,0,0,43,0,-43
20703,0,0,9,0,-9
20704,0,0,36,0,-36
20705,1,1,55,2613,2558
20706,0,0,130,0,-130
20707,0,0,9,0,-9
20708,0,0,53,0,-53
20709,1,1,736,1338,602
20710,1,0,7,0,-7
20711,0,0,3,0,-3
20712,0,0,100,0,-100
20713,1,1,95,1267,1172
20714,1,0,74,0,-74
20715,0,0,68,0,-68
20716,0,0,3,0,-3
20717,1,1,230,2546,2316
20718,1,0,5,0,-5
20719,1,1,510,1345,835
20720,1,1,332,1920,1588
20721,0,0,88,0,-88
20722,1,1,532,1507,975
20723,1,1,694,2062,1368
20724,0,0,20,0,-20
20725,0,0,82,0,-82
20726,1,0,10,0,-10
20727,1,0,56,0,-56
20728,1,1,419,1513,1094
20729,1,1,863,1344,481
20730,1,1,897,2353,1456
20731,0,0,87,0,-87
20732,0,0,56,0,-56
20733,0,0,5,0,-5
20734,1,0,11,0,-11
20735,1,1,568,1615,1047
20736,1,0,36,0,-36
20737,1,1,31,1260,1229
20738,0,0,87,0,-87
20739,1,1,163,1233,1070
20740,0,0,19,0,-19
20741,0,0,312,0,-312
20742,1,1,326,2712,2386
20743,1,1,385,1445,1060
20744,0,0,59,0,-59
20745,0,0,8,0,-8
20746,1,0,37,0,-37
20747,1,1,507,1305,798
20748,0,0,76,0,-76
20749,0,0,3,0,-3
20750,1,0,42,0,-42
20751,1,0,8,0,-8
20752,1,0,23,0,-23
20753,1,1,318,1778,1460
20754,1,1,302,1428,1126
20755,0,0,7,0,-7
20756,0,0,2,0,-2
20757,0,0,17,0,-17
20758,1,1,245,1270,1025
20759,0,0,38,0,-38
20760,1,0,4,0,-4
20761,1,1,401,1871,1470
20762,0,0,83,0,-83
20763,1,0,2,0,-2
20764,1,0,15,0,-15
20765,1,1,86,1254,1168
20766,1,0,0,0,0
20767,1,0,15,0,-15
20768,0,0,46,0,-46
20769,0,0,45,0,-45
20770,0,0,19,0,-19
20771,1,0,17,0,-17
20772,1,1,807,1310,503
20773,1,0,58,0,-58
20774,1,0,29,0,-29
20775,1,1,156,1731,1575
20776,1,0,11,0,-11
20777,0,0,10,0,-10
20778,1,0,36,0,-36
20779,0,0,87,0,-87
20780,0,0,7,0,-7
20781,0,0,257,0,-257
20782,0,0,180,0,-180
20783,0,0,20,0,-20
20784,1,0,109,0,-109
20785,0,0,2,0,-2
20786,1,0,30,0,-30
20787,1,0,29,0,-29
20788,1,1,393,1221,828
20789,1,1,74,2100,2026
20790,1,0,58,0,-58
20791,1,1,98,1282,1184
20792,1,1,48,1364,1316
20793,1,1,293,1353,1060
20794,1,0,7,0,-7
20795,1,0,17,0,-17
20796,1,1,706,1245,539
20797,0,0,6,0,-6
20798,0,0,38,0,-38
20799,0,0,13,0,-13
20800,1,1,913,2758,1845
20801,1,1,895,1537,642
20802,1,0,140,0,-140
20803,0,0,2,0,-2
20804,0,0,15,0,-15
20805,0,0,86,0,-86
20806,1,1,722,1314,592
20807,1,1,420,1377,957
20808,0,0,3,0,-3
20809,0,0,4,0,-4
20810,1,0,34,0,-34
20811,1,0,94,0,-94
20812,0,0,22,0,-22
20813,1,1,747,1414,667
20814,0,0,135,0,-135
20815,1,0,206,0,-206
20816,1,0,58,0,-58
20817,0,0,1,0,-1
20818,1,0,22,0,-22
20819,0,0,49,0,-49
20820,1,1,335,1630,1295
20821,0,0,16,0,-16
20822,1,0,6,0,-6
20823,0,0,12,0,-12
20824,1,1,1289,1546,257
20825,1,0,67,0,-67
20826,0,0,11,0,-11
20827,0,0,24,0,-24
20828,0,0,0,0,0
20829,1,1,822,1234,412
20830,1,0,5,0,-5
20831,0,0,50,0,-50
20832,1,1,1044,2134,1090
20833,1,1,755,1518,763
20834,0,0,11,0,-11
20835,1,0,17,0,-17
20836,1,0,22,0,-22
20837,1,1,312,1206,894
20838,0,0,16,0,-16
20839,0,0,8,0,-8
20840,1,0,9,0,-9
20841,1,1,505,1360,855
20842,1,0,82,0,-82
20843,1,1,303,2121,1818
20844,1,0,57,0,-57
20845,1,0,31,0,-31
20846,1,1,240,1707,1467
20847,1,1,38,1385,1347
20848,1,1,199,1673,1474
20849,1,0,24,0,-24
20850,0,0,27,0,-27
20851,1,0,7,0,-7
20852,1,1,136,2153,2017
20853,1,0,78,0,-78
20854,1,0,69,0,-69
20855,1,0,0,0,0
20856,1,0,2,0,-2
20857,1,1,115,1348,1233
20858,1,0,24,0,-24
20859,0,0,26,0,-26
20860,0,0,11,0,-11
20861,0,0,6,0,-6
20862,1,0,3,0,-3
20863,0,0,17,0,-17
20864,1,0,68,0,-68
20865,1,0,43,0,-43
20866,0,0,56,0,-56
20867,1,0,55,0,-55
20868,1,0,65,0,-65
20869,1,0,90,0,-90
20870,0,0,13,0,-13
20871,1,1,205,1344,1139
20872,0,0,52,0,-52
20873,0,0,20,0,-20
20874,0,0,354,0,-354
20875,1,0,40,0,-40
20876,1,0,32,0,-32
20877,0,0,31,0,-31
20878,1,0,31,0,-31
20879,1,0,98,0,-98
20880,1,1,346,2000,1654
20881,1,0,34,0,-34
20882,0,0,9,0,-9
20883,0,0,66,0,-66
20884,1,0,52,0,-52
20885,1,0,18,0,-18
20886,1,0,3,0,-3
20887,0,0,2,0,-2
20888,0,0,20,0,-20
20889,1,1,166,1285,1119
20890,1,0,34,0,-34
20891,1,0,79,0,-79
20892,1,0,87,0,-87
20893,0,0,16,0,-16
20894,0,0,277,0,-277
20895,0,0,68,0,-68
20896,0,0,35,0,-35
20897,0,0,90,0,-90
20898,1,1,19,1652,1633
20899,1,1,954,1406,452
20900,1,0,2,0,-2
20901,1,1,405,1276,871
20902,0,0,25,0,-25
20903,1,1,356,1897,1541
20904,1,1,2247,1226,-1021
20905,1,0,62,0,-62
20906,1,0,119,0,-119
20907,1,0,3,0,-3
20908,1,0,16,0,-16
20909,0,0,10,0,-10
20910,0,0,63,0,-63
20911,0,0,30,0,-30
20912,1,0,37,0,-37
20913,0,0,0,0,0
20914,0,0,5,0,-5
20915,1,1,119,1230,1111
20916,1,1,362,1249,887
20917,1,0,131,0,-131
20918,1,0,5,0,-5
20919,1,1,667,1452,785
20920,1,0,35,0,-35
20921,1,1,231,1963,1732
20922,0,0,30,0,-30
20923,1,1,484,1280,796
20924,1,1,749,1219,470
20925,1,1,178,2090,1912
20926,0,0,14,0,-14
20927,0,0,81,0,-81
20928,1,0,92,0,-92
20929,0,0,8,0,-8
20930,1,1,347,1328,981
20931,1,1,300,1256,956
20932,1,1,855,1201,346
20933,0,0,11,0,-11
20934,1,1,268,1211,943
20935,1,0,94,0,-94
20936,1,1,1422,2144,722
20937,0,0,44,0,-44
20938,1,0,134,0,-134
20939,1,0,59,0,-59
20940,1,1,389,1314,925
20941,1,0,145,0,-145
20942,1,1,439,1230,791
20943,1,1,370,1252,882
20944,1,1,552,1483,931
20945,0,0,1,0,-1
20946,1,0,62,0,-62
20947,1,0,8,0,-8
20948,0,0,2,0,-2
20949,0,0,73,0,-73
20950,1,1,1325,1498,173
20951,0,0,19,0,-19
20952,1,1,59,1519,1460
20953,0,0,18,0,-18
20954,1,0,10,0,-10
20955,1,0,19,0,-19
20956,1,1,207,1796,1589
20957,0,0,62,0,-62
20958,1,0,14,0,-14
20959,1,1,38,4164,4126
20960,0,0,38,0,-38
20961,1,1,183,1241,1058
20962,0,0,4,0,-4
20963,1,1,287,1221,934
20964,0,0,28,0,-28
20965,1,1,143,1261,1118
20966,1,0,1,0,-1
20967,1,0,95,0,-95
20968,0,0,39,0,-39
20969,1,1,134,2140,2006
20970,1,0,10,0,-10
20971,1,0,113,0,-113
20972,1,1,264,1655,1391
20973,1,0,108,0,-108
20974,0,0,30,0,-30
20975,1,0,27,0,-27
20976,1,0,111,0,-111
20977,1,0,35,0,-35
20978,1,0,14,0,-14
20979,1,1,914,1677,763
20980,1,0,58,0,-58
20981,1,0,6,0,-6
20982,1,0,0,0,0
20983,1,0,28,0,-28
20984,0,0,2,0,-2
20985,0,0,7,0,-7
20986,0,0,79,0,-79
20987,0,0,156,0,-156
20988,0,0,46,0,-46
20989,0,0,115,0,-115
20990,1,0,248,0,-248
20991,0,0,13,0,-13
20992,0,0,26,0,-26
20993,0,0,54,0,-54
20994,0,0,2,0,-2
20995,1,1,510,1301,791
20996,0,0,76,0,-76
20997,0,0,11,0,-11
20998,1,0,18,0,-18
20999,0,0,36,0,-36
21000,1,0,131,0,-131
21001,0,0,28,0,-28
21002,0,0,82,0,-82
21003,0,0,65,0,-65
21004,0,0,51,0,-51
21005,1,0,46,0,-46
21006,0,0,37,0,-37
21007,1,0,34,0,-34
21008,1,0,25,0,-25
21009,0,0,15,0,-15
21010,1,0,104,0,-104
21011,0,0,23,0,-23
21012,1,0,152,0,-152
21013,1,1,339,1217,878
21014,1,0,0,0,0
21015,0,0,33,0,-33
21016,0,0,33,0,-33
21017,1,1,144,2066,1922
21018,1,0,35,0,-35
21019,1,1,923,1240,317
21020,0,0,29,0,-29
21021,0,0,17,0,-17
21022,0,0,41,0,-41
21023,1,0,58,0,-58
21024,0,0,0,0,0
21025,1,1,378,3442,3064
21026,1,1,260,1224,964
21027,1,1,613,1891,1278
21028,1,0,47,0,-47
21029,0,0,32,0,-32
21030,1,0,33,0,-33
21031,0,0,73,0,-73
21032,0,0,17,0,-17
21033,1,1,404,1635,1231
21034,1,1,131,1354,1223
21035,1,1,555,1352,797
21036,1,0,65,0,-65
21037,1,1,877,1541,664
21038,0,0,50,0,-50
21039,0,0,2,0,-2
21040,0,0,44,0,-44
21041,0,0,61,0,-61
21042,1,0,81,0,-81
21043,0,0,12,0,-12
21044,1,1,150,1234,1084
21045,0,0,24,0,-24
21046,0,0,219,0,-219
21047,1,1,1185,1488,303
21048,1,1,2061,2223,162
21049,0,0,113,0,-113
21050,0,0,53,0,-53
21051,1,0,20,0,-20
21052,1,0,44,0,-44
21053,0,0,6,0,-6
21054,0,0,107,0,-107
21055,1,1,426,1794,1368
21056,1,0,7,0,-7
21057,1,0,19,0,-19
21058,1,1,311,1773,1462
21059,1,1,210,1850,1640
21060,1,0,24,0,-24
21061,1,0,69,0,-69
21062,0,0,33,0,-33
21063,1,1,294,1245,951
21064,0,0,73,0,-73
21065,0,0,47,0,-47
21066,0,0,9,0,-9
21067,0,0,114,0,-114
21068,1,1,917,1280,363
21069,1,1,483,1278,795
21070,1,0,13,0,-13
21071,1,0,69,0,-69
21072,1,0,21,0,-21
21073,1,0,45,0,-45
21074,1,0,66,0,-66
21075,0,0,92,0,-92
21076,0,0,0,0,0
21077,0,0,30,0,-30
21078,1,0,126,0,-126
21079,0,0,50,0,-50
21080,0,0,10,0,-10
21081,1,1,219,1569,1350
21082,1,1,199,1470,1271
21083,1,1,879,1210,331
21084,1,1,601,1240,639
21085,1,0,55,0,-55
21086,0,0,43,0,-43
21087,1,1,446,1935,1489
21088,1,0,90,0,-90
21089,1,1,822,1497,675
21090,1,1,467,1302,835
21091,0,0,99,0,-99
21092,1,0,89,0,-89
21093,1,1,659,2280,1621
21094,1,1,1124,1206,82
21095,0,0,268,0,-268
21096,1,1,192,1373,1181
21097,1,0,5,0,-5
21098,1,1,1942,1413,-529
21099,1,1,713,1206,493
21100,0,0,16,0,-16
21101,1,1,160,2032,1872
21102,0,0,10,0,-10
21103,0,0,60,0,-60
21104,0,0,14,0,-14
21105,0,0,61,0,-61
21106,0,0,42,0,-42
21107,1,0,86,0,-86
21108,1,1,1390,1633,243
21109,0,0,23,0,-23
21110,0,0,12,0,-12
21111,1,1,912,1514,602
21112,0,0,169,0,-169
21113,0,0,22,0,-22
21114,1,0,129,0,-129
21115,0,0,13,0,-13
21116,0,0,88,0,-88
21117,1,1,246,1261,1015
21118,0,0,9,0,-9
21119,1,1,1910,1202,-708
21120,0,0,5,0,-5
21121,1,0,76,0,-76
21122,1,0,42,0,-42
21123,1,1,506,1834,1328
21124,1,1,295,1606,1311
21125,1,1,33,1242,1209
21126,1,0,33,0,-33
21127,0,0,40,0,-40
21128,1,1,125,1305,1180
21129,1,1,282,1665,1383
21130,1,1,940,1212,272
21131,1,0,3,0,-3
21132,0,0,48,0,-48
21133,0,0,122,0,-122
21134,0,0,25,0,-25
21135,1,0,3,0,-3
21136,0,0,21,0,-21
21137,1,0,18,0,-18
21138,0,0,13,0,-13
21139,1,1,814,1250,436
21140,1,0,77,0,-77
21141,1,0,24,0,-24
21142,1,0,28,0,-28
21143,0,0,22,0,-22
21144,1,1,340,1963,1623
21145,0,0,2,0,-2
21146,1,1,458,1678,1220
21147,1,1,185,1291,1106
21148,1,0,34,0,-34
21149,1,1,626,1317,691
21150,1,0,21,0,-21
21151,1,1,897,1312,415
21152,0,0,90,0,-90
21153,1,0,34,0,-34
21154,1,0,23,0,-23
21155,0,0,32,0,-32
21156,1,1,1413,1263,-150
21157,1,0,88,0,-88
21158,0,0,13,0,-13
21159,1,1,113,1411,1298
21160,0,0,35,0,-35
21161,1,0,5,0,-5
21162,1,1,304,3538,3234
21163,0,0,55,0,-55
21164,1,0,33,0,-33
21165,0,0,102,0,-102
21166,0,0,64,0,-64
21167,1,1,1454,1218,-236
21168,1,1,168,1284,1116
21169,1,0,56,0,-56
21170,1,1,94,1237,1143
21171,1,0,11,0,-11
21172,0,0,59,0,-59
21173,1,1,67,1495,1428
21174,0,0,6,0,-6
21175,0,0,66,0,-66
21176,0,0,31,0,-31
21177,0,0,17,0,-17
21178,1,1,597,1334,737
21179,1,0,73,0,-73
21180,1,0,14,0,-14
21181,0,0,103,0,-103
21182,0,0,9,0,-9
21183,1,0,9,0,-9
21184,1,1,84,1289,1205
21185,1,1,78,1309,1231
21186,0,0,32,0,-32
21187,0,0,91,0,-91
21188,0,0,5,0,-5
21189,0,0,9,0,-9
21190,0,0,52,0,-52
21191,0,0,70,0,-70
21192,1,1,519,1477,958
21193,1,0,9,0,-9
21194,1,1,404,1272,868
21195,0,0,4,0,-4
21196,1,0,15,0,-15
21197,1,1,843,1338,495
21198,1,1,205,1650,1445
21199,1,1,52,2889,2837
21200,0,0,11,0,-11
21201,1,0,51,0,-51
21202,1,1,344,2103,1759
21203,1,1,1313,1256,-57
21204,1,0,2,0,-2
21205,0,0,8,0,-8
21206,1,0,180,0,-180
21207,1,0,8,0,-8
21208,1,0,41,0,-41
21209,0,0,15,0,-15
21210,0,0,79,0,-79
21211,1,0,10,0,-10
21212,1,0,22,0,-22
21213,0,0,44,0,-44
21214,1,1,256,1234,978
21215,1,1,1057,2365,1308
21216,0,0,6,0,-6
21217,0,0,9,0,-9
21218,1,0,87,0,-87
21219,0,0,5,0,-5
21220,1,1,290,1205,915
21221,1,1,284,1365,1081
21222,0,0,11,0,-11
21223,1,1,340,1531,1191
21224,1,0,60,0,-60
21225,0,0,24,0,-24
21226,1,0,7,0,-7
21227,1,1,315,1308,993
21228,1,1,315,1428,1113
21229,1,0,50,0,-50
21230,0,0,82,0,-82
21231,1,0,106,0,-106
21232,1,0,18,0,-18
21233,1,0,0,0,0
21234,1,1,45,1674,1629
21235,1,1,230,1278,1048
21236,1,0,61,0,-61
21237,0,0,48,0,-48
21238,1,1,201,1495,1294
21239,0,0,72,0,-72
21240,0,0,27,0,-27
21241,0,0,12,0,-12
21242,1,1,109,1446,1337
21243,1,1,87,1320,1233
21244,1,0,6,0,-6
21245,0,0,24,0,-24
21246,1,1,262,1340,1078
21247,1,1,1132,1473,341
21248,0,0,7,0,-7
21249,1,0,135,0,-135
21250,1,1,136,1962,1826
21251,0,0,39,0,-39
21252,0,0,75,0,-75
21253,0,0,23,0,-23
21254,0,0,42,0,-42
21255,1,0,4,0,-4
21256,0,0,19,0,-19
21257,1,0,33,0,-33
21258,0,0,136,0,-136
21259,1,1,902,1227,325
21260,0,0,22,0,-22
21261,1,1,614,3245,2631
21262,1,1,2206,1268,-938
21263,1,1,569,1554,985
21264,1,0,16,0,-16
21265,1,1,284,1280,996
21266,0,0,16,0,-16
21267,0,0,51,0,-51
21268,0,0,112,0,-112
21269,0,0,6,0,-6
21270,0,0,193,0,-193
21271,1,0,80,0,-80
21272,0,0,46,0,-46
21273,1,0,118,0,-118
21274,0,0,40,0,-40
21275,0,0,49,0,-49
21276,0,0,30,0,-30
21277,1,0,83,0,-83
21278,0,0,61,0,-61
21279,0,0,34,0,-34
21280,0,0,9,0,-9
21281,1,0,41,0,-41
21282,1,1,384,2063,1679
21283,1,0,1,0,-1
21284,0,0,44,0,-44
21285,1,0,8,0,-8
21286,1,1,209,1242,1033
21287,0,0,7,0,-7
21288,0,0,7,0,-7
21289,1,1,535,1548,1013
21290,0,0,93,0,-93
21291,0,0,126,0,-126
21292,0,0,14,0,-14
21293,1,1,617,1242,625
21294,0,0,16,0,-16
21295,1,0,9,0,-9
21296,0,0,1,0,-1
21297,0,0,32,0,-32
21298,0,0,45,0,-45
21299,0,0,35,0,-35
21300,1,0,126,0,-126
21301,1,1,425,2403,1978
21302,1,1,91,1430,1339
21303,0,0,10,0,-10
21304,0,0,72,0,-72
21305,1,0,103,0,-103
21306,0,0,300,0,-300
21307,1,0,83,0,-83
21308,1,1,1048,1777,729
21309,1,0,27,0,-27
21310,0,0,57,0,-57
21311,0,0,32,0,-32
21312,0,0,11,0,-11
21313,0,0,123,0,-123
21314,1,1,1290,2636,1346
21315,0,0,41,0,-41
21316,1,0,3,0,-3
21317,1,0,105,0,-105
21318,0,0,63,0,-63
21319,0,0,35,0,-35
21320,0,0,45,0,-45
21321,1,1,680,1732,1052
21322,0,0,37,0,-37
21323,1,1,613,1556,943
21324,1,1,253,1216,963
21325,0,0,63,0,-63
21326,1,0,78,0,-78
21327,1,1,551,1365,814
21328,1,1,986,1653,667
21329,1,0,4,0,-4
21330,0,0,32,0,-32
21331,1,0,42,0,-42
21332,1,1,542,1516,974
21333,1,0,7,0,-7
21334,0,0,2,0,-2
21335,1,0,8,0,-8
21336,0,0,85,0,-85
21337,1,1,609,2287,1678
21338,0,0,5,0,-5
21339,0,0,3,0,-3
21340,1,0,10,0,-10
21341,0,0,2,0,-2
21342,0,0,33,0,-33
21343,0,0,34,0,-34
21344,1,0,96,0,-96
21345,1,1,807,1612,805
21346,1,1,1144,1263,119
21347,0,0,55,0,-55
21348,0,0,3,0,-3
21349,0,0,11,0,-11
21350,0,0,7,0,-7
21351,1,1,221,1358,1137
21352,1,1,361,2385,2024
21353,0,0,1,0,-1
21354,1,1,187,1949,1762
21355,1,0,46,0,-46
21356,0,0,5,0,-5
21357,1,0,140,0,-140
21358,0,0,27,0,-27
21359,1,1,130,1399,1269
21360,1,0,49,0,-49
21361,0,0,122,0,-122
21362,0,0,67,0,-67
21363,0,0,25,0,-25
21364,1,1,123,1331,1208
21365,1,1,1210,1309,99
21366,1,1,153,1890,1737
21367,0,0,9,0,-9
21368,1,0,10,0,-10
21369,0,0,1,0,-1
21370,0,0,7,0,-7
21371,0,0,12,0,-12
21372,0,0,25,0,-25
21373,1,0,31,0,-31
21374,1,0,92,0,-92
21375,0,0,37,0,-37
21376,1,0,14,0,-14
21377,1,1,319,1390,1071
21378,1,1,977,1525,548
21379,1,1,450,1785,1335
21380,1,0,36,0,-36
21381,1,0,55,0,-55
21382,1,1,128,1376,1248
21383,1,0,63,0,-63
21384,1,0,86,0,-86
21385,0,0,95,0,-95
21386,1,0,70,0,-70
21387,0,0,14,0,-14
21388,1,1,258,1228,970
21389,0,0,30,0,-30
21390,1,1,754,1277,523
21391,1,0,8,0,-8
21392,1,0,55,0,-55
21393,0,0,22,0,-22
21394,1,1,1277,1274,-3
21395,1,0,64,0,-64
21396,1,1,969,1313,344
21397,1,1,91,1514,1423
21398,1,1,423,2040,1617
21399,0,0,56,0,-56
21400,0,0,70,0,-70
21401,1,0,11,0,-11
21402,1,0,3,0,-3
21403,0,0,30,0,-30
21404,0,0,24,0,-24
21405,0,0,18,0,-18
21406,1,1,386,1320,934
21407,1,0,74,0,-74
21408,1,1,3061,1267,-1794
21409,1,0,193,0,-193
21410,1,0,40,0,-40
21411,1,0,26,0,-26
21412,1,0,41,0,-41
21413,1,0,3,0,-3
21414,0,0,129,0,-129
21415,0,0,225,0,-225
21416,0,0,70,0,-70
21417,1,0,57,0,-57
21418,1,0,36,0,-36
21419,1,0,30,0,-30
21420,0,0,46,0,-46
21421,1,1,238,1350,1112
21422,0,0,4,0,-4
21423,0,0,33,0,-33
21424,0,0,127,0,-127
21425,0,0,33,0,-33
21426,1,0,100,0,-100
21427,0,0,12,0,-12
21428,0,0,31,0,-31
21429,1,0,2,0,-2
21430,1,0,10,0,-10
21431,1,1,385,1276,891
21432,0,0,31,0,-31
21433,1,1,309,1348,1039
21434,1,1,29,1207,1178
21435,1,1,843,1268,425
21436,1,1,637,2063,1426
21437,0,0,10,0,-10
21438,1,0,29,0,-29
21439,0,0,3,0,-3
21440,1,0,39,0,-39
21441,0,0,23,0,-23
21442,0,0,52,0,-52
21443,1,0,2,0,-2
21444,1,1,564,1226,662
21445,1,0,83,0,-83
21446,0,0,23,0,-23
21447,1,1,264,1940,1676
21448,1,1,167,1596,1429
21449,1,1,500,1203,703
21450,1,1,743,1214,471
21451,0,0,1,0,-1
21452,1,0,27,0,-27
21453,0,0,51,0,-51
21454,0,0,118,0,-118
21455,0,0,30,0,-30
21456,0,0,97,0,-97
21457,1,1,457,1384,927
21458,0,0,28,0,-28
21459,1,1,167,1945,1778
21460,1,1,91,2233,2142
21461,1,0,7,0,-7
21462,1,0,10,0,-10
21463,1,0,106,0,-106
21464,0,0,21,0,-21
21465,0,0,68,0,-68
21466,1,0,119,0,-119
21467,0,0,86,0,-86
21468,1,1,639,1332,693
21469,1,1,414,2478,2064
21470,0,0,19,0,-19
21471,0,0,95,0,-95
21472,1,1,175,1237,1062
21473,1,0,93,0,-93
21474,1,1,1473,1257,-216
21475,1,1,192,1415,1223
21476,0,0,34,0,-34
21477,1,1,160,1222,1062
21478,0,0,4,0,-4
21479,1,0,81,0,-81
21480,1,0,57,0,-57
21481,1,1,808,1895,1087
21482,1,1,589,1705,1116
21483,1,1,949,1370,421
21484,0,0,4,0,-4
21485,1,0,5,0,-5
21486,0,0,75,0,-75
21487,1,0,16,0,-16
21488,0,0,62,0,-62
21489,1,1,483,1252,769
21490,1,1,468,2018,1550
21491,1,0,34,0,-34
21492,1,1,573,1305,732
21493,1,0,200,0,-200
21494,1,0,1,0,-1
21495,0,0,25,0,-25
21496,0,0,28,0,-28
21497,1,1,618,1213,595
21498,0,0,66,0,-66
21499,1,0,66,0,-66
21500,0,0,1,0,-1
21501,0,0,33,0,-33
21502,1,1,187,1303,1116
21503,0,0,30,0,-30
21504,1,1,563,1236,673
21505,0,0,1,0,-1
21506,1,0,10,0,-10
21507,0,0,70,0,-70
21508,1,0,65,0,-65
21509,1,0,56,0,-56
21510,1,0,41,0,-41
21511,1,0,9,0,-9
21512,1,0,0,0,0
21513,1,0,10,0,-10
21514,0,0,41,0,-41
21515,1,0,30,0,-30
21516,1,1,514,1442,928
21517,0,0,59,0,-59
21518,1,1,806,1260,454
21519,1,0,50,0,-50
21520,0,0,40,0,-40
21521,0,0,48,0,-48
21522,0,0,136,0,-136
21523,0,0,2,0,-2
21524,0,0,24,0,-24
21525,0,0,53,0,-53
21526,1,1,411,1519,1108
21527,0,0,194,0,-194
21528,1,0,154,0,-154
21529,1,1,257,1401,1144
21530,1,1,819,1513,694
21531,1,1,395,1399,1004
21532,0,0,62,0,-62
21533,0,0,60,0,-60
21534,1,0,29,0,-29
21535,0,0,52,0,-52
21536,1,1,275,1348,1073
21537,1,0,3,0,-3
21538,0,0,31,0,-31
21539,0,0,45,0,-45
21540,0,0,41,0,-41
21541,1,0,36,0,-36
21542,0,0,86,0,-86
21543,1,1,1464,1245,-219
21544,0,0,49,0,-49
21545,1,1,448,2802,2354
21546,0,0,52,0,-52
21547,1,0,54,0,-54
21548,1,0,6,0,-6
21549,0,0,61,0,-61
21550,1,0,20,0,-20
21551,1,0,61,0,-61
21552,0,0,25,0,-25
21553,1,1,280,1210,930
21554,1,1,199,1505,1306
21555,1,0,104,0,-104
21556,1,0,67,0,-67
21557,1,0,90,0,-90
21558,1,1,1167,2361,1194
21559,1,1,1851,2065,214
21560,1,0,26,0,-26
21561,1,0,162,0,-162
21562,1,0,65,0,-65
21563,1,1,288,1312,1024
21564,1,0,34,0,-34
21565,1,1,1015,1387,372
21566,1,1,531,1662,1131
21567,1,1,448,1200,752
21568,1,0,46,0,-46
21569,0,0,18,0,-18
21570,0,0,24,0,-24
21571,1,1,99,1278,1179
21572,0,0,58,0,-58
21573,1,0,65,0,-65
21574,0,0,38,0,-38
21575,1,0,32,0,-32
21576,1,0,11,0,-11
21577,1,0,133,0,-133
21578,1,0,43,0,-43
21579,0,0,50,0,-50
21580,1,1,501,1261,760
21581,1,0,232,0,-232
21582,1,1,525,1639,1114
21583,1,1,541,1250,709
21584,1,0,24,0,-24
21585,0,0,31,0,-31
21586,1,1,519,2282,1763
21587,1,0,8,0,-8
21588,1,0,149,0,-149
21589,1,0,39,0,-39
21590,1,1,1697,1435,-262
21591,1,0,67,0,-67
21592,0,0,14,0,-14
21593,1,0,6,0,-6
21594,1,1,594,1258,664
21595,0,0,30,0,-30
21596,1,1,653,1427,774
21597,0,0,45,0,-45
21598,0,0,103,0,-103
21599,0,0,2,0,-2
21600,1,1,422,1247,825
21601,0,0,52,0,-52
21602,1,1,834,2379,1545
21603,1,1,894,1974,1080
21604,1,0,22,0,-22
21605,0,0,112,0,-112
21606,1,0,24,0,-24
21607,1,1,571,1347,776
21608,0,0,61,0,-61
21609,0,0,62,0,-62
21610,1,0,0,0,0
21611,1,0,136,0,-136
21612,1,1,922,1246,324
21613,0,0,55,0,-55
21614,0,0,54,0,-54
21615,1,1,85,2453,2368
21616,0,0,5,0,-5
21617,0,0,4,0,-4
21618,0,0,8,0,-8
21619,0,0,3,0,-3
21620,0,0,30,0,-30
21621,0,0,26,0,-26
21622,1,0,9,0,-9
21623,1,1,376,1301,925
21624,0,0,37,0,-37
21625,0,0,46,0,-46
21626,1,0,84,0,-84
21627,0,0,18,0,-18
21628,1,1,343,1240,897
21629,0,0,0,0,0
21630,1,1,123,1706,1583
21631,0,0,22,0,-22
21632,1,0,65,0,-65
21633,1,0,15,0,-15
21634,1,0,29,0,-29
21635,1,1,312,1653,1341
21636,1,0,59,0,-59
21637,0,0,12,0,-12
21638,0,0,18,0,-18
21639,0,0,241,0,-241
21640,0,0,19,0,-19
21641,0,0,29,0,-29
21642,1,0,84,0,-84
21643,1,0,18,0,-18
21644,1,0,43,0,-43
21645,0,0,199,0,-199
21646,0,0,49,0,-49
21647,0,0,90,0,-90
21648,1,0,15,0,-15
21649,0,0,33,0,-33
21650,0,0,264,0,-264
21651,0,0,112,0,-112
21652,1,1,145,1306,1161
21653,0,0,63,0,-63
21654,0,0,77,0,-77
21655,0,0,31,0,-31
21656,1,1,86,1283,1197
21657,1,0,31,0,-31
21658,1,0,56,0,-56
21659,1,0,122,0,-122
21660,1,0,13,0,-13
21661,0,0,76,0,-76
21662,1,0,69,0,-69
21663,0,0,25,0,-25
21664,1,1,306,1391,1085
21665,0,0,9,0,-9
21666,0,0,44,0,-44
21667,1,1,1414,1508,94
21668,1,0,20,0,-20
21669,1,1,585,1427,842
21670,0,0,132,0,-132
21671,1,1,83,1260,1177
21672,1,1,560,1376,816
21673,1,0,87,0,-87
21674,0,0,47,0,-47
21675,1,0,10,0,-10
21676,0,0,81,0,-81
21677,1,0,51,0,-51
21678,1,1,1476,1538,62
21679,1,0,119,0,-119
21680,0,0,40,0,-40
21681,1,0,33,0,-33
21682,1,1,1023,1356,333
21683,1,1,59,1247,1188
21684,1,0,59,0,-59
21685,1,1,736,2679,1943
21686,1,0,20,0,-20
21687,0,0,45,0,-45
21688,1,0,23,0,-23
21689,1,0,58,0,-58
21690,1,0,8,0,-8
21691,1,1,585,2482,1897
21692,1,1,514,1475,961
21693,1,1,39,1295,1256
21694,1,1,203,1307,1104
21695,0,0,60,0,-60
21696,1,0,9,0,-9
21697,1,0,177,0,-177
21698,1,0,33,0,-33
21699,1,1,904,1277,373
21700,0,0,68,0,-68
21701,0,0,106,0,-106
21702,0,0,56,0,-56
21703,1,1,192,1309,1117
21704,0,0,4,0,-4
21705,0,0,200,0,-200
21706,1,0,39,0,-39
21707,0,0,31,0,-31
21708,1,1,271,1223,952
21709,1,0,18,0,-18
21710,0,0,31,0,-31
21711,1,0,113,0,-113
21712,1,0,6,0,-6
21713,0,0,22,0,-22
21714,1,1,411,1454,1043
21715,1,1,429,1349,920
21716,1,1,1261,1353,92
21717,0,0,38,0,-38
21718,1,1,114,2194,2080
21719,0,0,32,0,-32
21720,0,0,70,0,-70
21721,1,1,2483,1471,-1012
21722,1,1,467,2023,1556
21723,1,1,299,1225,926
21724,1,0,7,0,-7
21725,0,0,106,0,-106
21726,1,1,263,2056,1793
21727,0,0,40,0,-40
21728,1,0,31,0,-31
21729,0,0,21,0,-21
21730,1,0,75,0,-75
21731,1,1,131,1363,1232
21732,1,0,33,0,-33
21733,1,1,177,1393,1216
21734,0,0,64,0,-64
21735,0,0,79,0,-79
21736,0,0,103,0,-103
21737,1,0,66,0,-66
21738,1,1,614,1445,831
21739,0,0,50,0,-50
21740,1,1,169,2002,1833
21741,1,1,755,1791,1036
21742,1,1,750,1412,662
21743,1,1,1453,1241,-212
21744,1,0,15,0,-15
21745,1,0,19,0,-19
21746,1,1,57,1214,1157
21747,0,0,41,0,-41
21748,0,0,10,0,-10
21749,0,0,22,0,-22
21750,1,0,110,0,-110
21751,1,0,60,0,-60
21752,1,0,117,0,-117
21753,1,1,386,1659,1273
21754,1,0,91,0,-91
21755,1,1,470,2195,1725
21756,1,1,622,1396,774
21757,1,1,559,1544,985
21758,1,0,23,0,-23
21759,0,0,53,0,-53
21760,1,0,38,0,-38
21761,1,1,215,1343,1128
21762,0,0,69,0,-69
21763,1,1,159,1218,1059
21764,1,1,2680,3580,900
21765,1,1,1198,3087,1889
21766,0,0,59,0,-59
21767,0,0,94,0,-94
21768,1,1,258,1314,1056
21769,1,1,429,2145,1716
21770,0,0,17,0,-17
21771,1,0,58,0,-58
21772,1,1,208,1333,1125
21773,0,0,176,0,-176
21774,0,0,4,0,-4
21775,0,0,1,0,-1
21776,0,0,5,0,-5
21777,1,0,1,0,-1
21778,0,0,180,0,-180
21779,1,0,32,0,-32
21780,0,0,20,0,-20
21781,1,0,74,0,-74
21782,1,1,869,1430,561
21783,1,1,155,2934,2779
21784,0,0,64,0,-64
21785,1,1,786,1370,584
21786,1,0,39,0,-39
21787,1,1,536,1226,690
21788,1,1,436,1279,843
21789,1,1,137,1224,1087
21790,0,0,4,0,-4
21791,0,0,97,0,-97
21792,1,0,5,0,-5
21793,0,0,36,0,-36
21794,1,1,349,1303,954
21795,0,0,16,0,-16
21796,1,1,150,1423,1273
21797,1,1,102,2248,2146
21798,1,1,2123,1319,-804
21799,1,0,85,0,-85
21800,0,0,71,0,-71
21801,1,1,1442,1239,-203
21802,0,0,46,0,-46
21803,1,0,16,0,-16
21804,1,0,82,0,-82
21805,0,0,14,0,-14
21806,1,0,20,0,-20
21807,1,0,35,0,-35
21808,0,0,19,0,-19
21809,1,1,394,1379,985
21810,1,0,75,0,-75
21811,0,0,106,0,-106
21812,0,0,35,0,-35
21813,1,1,25,2077,2052
21814,1,0,7,0,-7
21815,1,1,1255,1204,-51
21816,1,1,516,2241,1725
21817,1,0,14,0,-14
21818,0,0,128,0,-128
21819,1,0,114,0,-114
21820,1,0,84,0,-84
21821,1,0,39,0,-39
21822,0,0,3,0,-3
21823,1,0,124,0,-124
21824,1,1,83,1567,1484
21825,1,0,13,0,-13
21826,1,0,95,0,-95
21827,1,0,8,0,-8
21828,1,0,96,0,-96
21829,1,1,127,1499,1372
21830,0,0,51,0,-51
21831,1,0,5,0,-5
21832,1,0,16,0,-16
21833,1,1,381,1202,821
21834,1,0,2,0,-2
21835,0,0,7,0,-7
21836,1,0,110,0,-110
21837,0,0,10,0,-10
21838,0,0,5,0,-5
21839,1,0,13,0,-13
21840,0,0,17,0,-17
21841,1,1,666,1245,579
21842,0,0,5,0,-5
21843,1,1,90,1861,1771
21844,0,0,8,0,-8
21845,0,0,116,0,-116
21846,0,0,22,0,-22
21847,0,0,94,0,-94
21848,0,0,21,0,-21
21849,1,1,890,1499,609
21850,1,1,205,1567,1362
21851,1,0,105,0,-105
21852,1,1,481,1211,730
21853,1,0,19,0,-19
21854,1,0,10,0,-10
21855,1,0,16,0,-16
21856,1,1,1291,1603,312
21857,1,1,762,1347,585
21858,1,1,248,1675,1427
21859,1,1,1836,1472,-364
21860,1,0,18,0,-18
21861,1,1,520,1208,688
21862,0,0,50,0,-50
21863,0,0,28,0,-28
21864,1,0,109,0,-109
21865,1,1,996,4409,3413
21866,1,0,60,0,-60
21867,0,0,54,0,-54
21868,0,0,76,0,-76
21869,1,1,49,1200,1151
21870,1,1,167,1211,1044
21871,0,0,12,0,-12
21872,1,1,648,1922,1274
21873,1,0,26,0,-26
21874,1,1,82,1292,1210
21875,1,1,623,1240,617
21876,0,0,63,0,-63
21877,1,1,577,3922,3345
21878,1,1,2109,1240,-869
21879,1,1,427,1205,778
21880,0,0,5,0,-5
21881,1,1,150,1531,1381
21882,1,0,9,0,-9
21883,1,1,75,1430,1355
21884,1,1,467,1215,748
21885,0,0,2,0,-2
21886,1,0,7,0,-7
21887,0,0,212,0,-212
21888,0,0,30,0,-30
21889,1,0,15,0,-15
21890,0,0,27,0,-27
21891,0,0,11,0,-11
21892,0,0,49,0,-49
21893,0,0,16,0,-16
21894,1,0,47,0,-47
21895,0,0,79,0,-79
21896,0,0,52,0,-52
21897,0,0,10,0,-10
21898,1,1,264,1211,947
21899,1,1,938,1819,881
21900,1,0,106,0,-106
21901,1,0,72,0,-72
21902,1,1,551,2100,1549
21903,1,0,113,0,-113
21904,1,1,2470,1203,-1267
21905,1,1,442,1693,1251
21906,0,0,59,0,-59
21907,0,0,130,0,-130
21908,1,1,159,1230,1071
21909,1,0,26,0,-26
21910,1,0,183,0,-183
21911,1,0,40,0,-40
21912,0,0,8,0,-8
21913,1,1,227,1456,1229
21914,0,0,78,0,-78
21915,0,0,46,0,-46
21916,1,1,209,1376,1167
21917,1,0,45,0,-45
21918,1,1,83,1313,1230
21919,0,0,3,0,-3
21920,0,0,115,0,-115
21921,0,0,37,0,-37
21922,0,0,85,0,-85
21923,1,1,184,1410,1226
21924,0,0,97,0,-97
21925,1,0,33,0,-33
21926,0,0,19,0,-19
21927,1,1,742,1234,492
21928,1,0,63,0,-63
21929,1,0,74,0,-74
21930,0,0,19,0,-19
21931,1,0,1,0,-1
21932,1,0,49,0,-49
21933,1,0,14,0,-14
21934,1,1,2095,1757,-338
21935,1,1,341,1202,861
21936,0,0,39,0,-39
21937,0,0,29,0,-29
21938,1,0,32,0,-32
21939,1,0,131,0,-131
21940,1,1,85,2010,1925
21941,1,0,10,0,-10
21942,0,0,41,0,-41
21943,0,0,170,0,-170
21944,0,0,56,0,-56
21945,1,0,53,0,-53
21946,0,0,125,0,-125
21947,1,0,18,0,-18
21948,1,1,167,1408,1241
21949,1,1,608,1339,731
21950,1,1,1011,1722,711
21951,1,0,56,0,-56
21952,0,0,5,0,-5
21953,1,0,53,0,-53
21954,0,0,38,0,-38
21955,1,0,46,0,-46
21956,1,1,450,3959,3509
21957,0,0,31,0,-31
21958,0,0,86,0,-86
21959,1,1,614,1315,701
21960,1,1,407,4954,4547
21961,1,0,21,0,-21
21962,1,1,428,1515,1087
21963,0,0,16,0,-16
21964,1,1,328,1485,1157
21965,0,0,44,0,-44
21966,1,0,41,0,-41
21967,1,1,182,1253,1071
21968,1,1,81,1540,1459
21969,1,0,13,0,-13
21970,0,0,131,0,-131
21971,1,0,25,0,-25
21972,1,1,233,1567,1334
21973,1,0,47,0,-47
21974,0,0,63,0,-63
21975,1,0,56,0,-56
21976,1,0,52,0,-52
21977,0,0,18,0,-18
21978,1,1,578,1382,804
21979,1,1,210,1357,1147
21980,1,1,71,1257,1186
21981,1,0,18,0,-18
21982,0,0,60,0,-60
21983,0,0,51,0,-51
21984,0,0,5,0,-5
21985,1,0,4,0,-4
21986,1,0,130,0,-130
21987,0,0,24,0,-24
21988,0,0,6,0,-6
21989,1,0,76,0,-76
21990,1,0,69,0,-69
21991,1,1,263,1603,1340
21992,1,0,23,0,-23
21993,1,1,942,2416,1474
21994,0,0,9,0,-9
21995,1,1,912,1426,514
21996,0,0,1,0,-1
21997,1,0,61,0,-61
21998,1,0,32,0,-32
21999,1,1,493,1357,864
22000,1,1,257,1496,1239
22001,1,1,423,1217,794
22002,1,0,138,0,-138
22003,1,1,691,2207,1516
22004,1,1,1453,1337,-116
22005,1,0,55,0,-55
22006,1,1,420,1312,892
22007,0,0,94,0,-94
22008,1,0,17,0,-17
22009,0,0,42,0,-42
22010,0,0,23,0,-23
22011,0,0,94,0,-94
22012,1,1,227,1636,1409
22013,0,0,14,0,-14
22014,1,1,1050,1976,926
22015,0,0,0,0,0
22016,1,1,63,1449,1386
22017,1,1,793,1221,428
22018,0,0,45,0,-45
22019,0,0,49,0,-49
22020,0,0,37,0,-37
22021,1,0,17,0,-17
22022,1,0,29,0,-29
22023,1,0,13,0,-13
22024,1,1,859,1337,478
22025,0,0,30,0,-30
22026,0,0,49,0,-49
22027,0,0,37,0,-37
22028,1,1,575,2319,1744
22029,1,0,2,0,-2
22030,0,0,3,0,-3
22031,1,0,103,0,-103
22032,0,0,114,0,-114
22033,0,0,4,0,-4
22034,1,1,34,2754,2720
22035,0,0,31,0,-31
22036,1,0,3,0,-3
22037,1,1,1262,1325,63
22038,1,0,3,0,-3
22039,0,0,41,0,-41
22040,1,1,876,1830,954
22041,1,1,998,1682,684
22042,1,0,0,0,0
22043,1,1,6,1528,1522
22044,1,0,66,0,-66
22045,0,0,60,0,-60
22046,0,0,76,0,-76
22047,1,0,51,0,-51
22048,0,0,135,0,-135
22049,0,0,111,0,-111
22050,1,0,93,0,-93
22051,1,1,1705,2773,1068
22052,0,0,37,0,-37
22053,0,0,4,0,-4
22054,0,0,112,0,-112
22055,1,0,0,0,0
22056,0,0,19,0,-19
22057,1,0,165,0,-165
22058,0,0,285,0,-285
22059,1,0,137,0,-137
22060,0,0,20,0,-20
22061,1,0,10,0,-10
22062,1,1,422,1455,1033
22063,0,0,71,0,-71
22064,0,0,5,0,-5
22065,1,0,52,0,-52
22066,0,0,155,0,-155
22067,1,0,59,0,-59
22068,0,0,48,0,-48
22069,1,1,479,1866,1387
22070,0,0,35,0,-35
22071,1,1,736,1623,887
22072,1,0,5,0,-5
22073,1,0,83,0,-83
22074,0,0,10,0,-10
22075,1,0,52,0,-52
22076,1,1,1171,1949,778
22077,0,0,136,0,-136
22078,0,0,77,0,-77
22079,1,1,100,1289,1189
22080,1,0,2,0,-2
22081,0,0,11,0,-11
22082,0,0,11,0,-11
22083,1,0,60,0,-60
22084,1,1,107,1359,1252
22085,0,0,12,0,-12
22086,1,0,31,0,-31
22087,1,0,2,0,-2
22088,1,1,144,1463,1319
22089,0,0,66,0,-66
22090,1,0,15,0,-15
22091,1,0,53,0,-53
22092,0,0,101,0,-101
22093,0,0,33,0,-33
22094,0,0,105,0,-105
22095,1,1,93,2738,2645
22096,0,0,8,0,-8
22097,1,0,102,0,-102
22098,0,0,3,0,-3
22099,0,0,23,0,-23
22100,1,0,168,0,-168
22101,1,0,24,0,-24
22102,1,1,265,1206,941
22103,1,1,246,1548,1302
22104,1,0,117,0,-117
22105,1,1,498,1542,1044
22106,0,0,9,0,-9
22107,1,0,6,0,-6
22108,1,0,19,0,-19
22109,0,0,11,0,-11
22110,1,0,3,0,-3
22111,0,0,3,0,-3
22112,1,1,227,1472,1245
22113,0,0,102,0,-102
22114,0,0,56,0,-56
22115,0,0,12,0,-12
22116,1,1,505,1649,1144
22117,0,0,27,0,-27
22118,0,0,66,0,-66
22119,1,1,475,1553,1078
22120,1,1,221,1302,1081
22121,1,0,32,0,-32
22122,0,0,35,0,-35
22123,0,0,57,0,-57
22124,1,1,609,1229,620
22125,0,0,101,0,-101
22126,0,0,32,0,-32
22127,0,0,68,0,-68
22128,1,1,392,1747,1355
22129,1,0,6,0,-6
22130,1,1,54,1735,1681
22131,1,0,12,0,-12
22132,1,0,16,0,-16
22133,1,1,44,1207,1163
22134,0,0,99,0,-99
22135,1,1,567,1439,872
22136,1,1,514,1420,906
22137,0,0,37,0,-37
22138,1,1,463,1202,739
22139,1,1,131,1448,1317
22140,0,0,21,0,-21
22141,1,1,236,1306,1070
22142,0,0,13,0,-13
22143,0,0,62,0,-62
22144,0,0,0,0,0
22145,0,0,5,0,-5
22146,0,0,35,0,-35
22147,1,1,820,1248,428
22148,0,0,101,0,-101
22149,0,0,61,0,-61
22150,1,0,13,0,-13
22151,0,0,18,0,-18
22152,0,0,57,0,-57
22153,1,0,103,0,-103
22154,1,0,55,0,-55
22155,1,0,158,0,-158
22156,1,1,498,1994,1496
22157,1,1,326,1920,1594
22158,1,1,1058,1320,262
22159,1,0,7,0,-7
22160,1,1,82,1538,1456
22161,0,0,10,0,-10
22162,0,0,61,0,-61
22163,0,0,68,0,-68
22164,1,1,282,1468,1186
22165,1,0,29,0,-29
22166,1,1,741,1460,719
22167,1,1,196,2521,2325
22168,0,0,3,0,-3
22169,0,0,31,0,-31
22170,1,0,108,0,-108
22171,0,0,46,0,-46
22172,0,0,38,0,-38
22173,1,1,294,1314,1020
22174,1,1,224,2054,1830
22175,1,0,6,0,-6
22176,0,0,64,0,-64
22177,1,1,29,1210,1181
22178,1,1,91,1204,1113
22179,0,0,27,0,-27
22180,1,1,85,2557,2472
22181,0,0,81,0,-81
22182,0,0,56,0,-56
22183,1,0,5,0,-5
22184,1,1,60,2062,2002
22185,1,0,63,0,-63
22186,0,0,3,0,-3
22187,1,1,247,1438,1191
22188,0,0,1,0,-1
22189,1,0,30,0,-30
22190,0,0,36,0,-36
22191,1,0,11,0,-11
22192,0,0,45,0,-45
22193,1,0,46,0,-46
22194,0,0,7,0,-7
22195,1,0,15,0,-15
22196,1,1,1418,1512,94
22197,0,0,23,0,-23
22198,1,0,31,0,-31
22199,0,0,5,0,-5
22200,0,0,33,0,-33
22201,1,0,143,0,-143
22202,0,0,46,0,-46
22203,1,0,0,0,0
22204,1,1,1020,1285,265
22205,0,0,64,0,-64
22206,1,1,288,1392,1104
22207,1,0,79,0,-79
22208,1,0,68,0,-68
22209,0,0,52,0,-52
22210,1,1,41,1236,1195
22211,1,1,33,1358,1325
22212,1,0,80,0,-80
22213,1,1,1981,1290,-691
22214,1,1,330,1905,1575
22215,1,1,68,1886,1818
22216,1,1,288,1444,1156
22217,1,1,1195,1424,229
22218,1,0,71,0,-71
22219,1,1,629,1503,874
22220,1,1,397,1216,819
22221,1,1,50,1289,1239
22222,1,0,15,0,-15
22223,1,1,742,1273,531
22224,1,0,31,0,-31
22225,1,1,309,1438,1129
22226,1,1,362,1286,924
22227,0,0,9,0,-9
22228,1,1,1053,1400,347
22229,0,0,152,0,-152
22230,1,1,787,1281,494
22231,0,0,30,0,-30
22232,1,0,9,0,-9
22233,1,1,63,1568,1505
22234,1,1,214,1282,1068
22235,1,1,28,1226,1198
22236,1,1,1549,3012,1463
22237,0,0,92,0,-92
22238,1,0,148,0,-148
22239,1,0,0,0,0
22240,0,0,303,0,-303
22241,0,0,12,0,-12
22242,1,1,953,1626,673
22243,1,1,676,1316,640
22244,0,0,109,0,-109
22245,1,0,58,0,-58
22246,1,0,127,0,-127
22247,1,0,28,0,-28
22248,0,0,11,0,-11
22249,1,1,60,1339,1279
22250,1,1,603,1287,684
22251,0,0,12,0,-12
22252,0,0,21,0,-21
22253,1,1,50,1329,1279
22254,0,0,188,0,-188
22255,1,0,4,0,-4
22256,1,1,152,1329,1177
22257,1,1,224,1766,1542
22258,1,1,860,2535,1675
22259,0,0,115,0,-115
22260,0,0,6,0,-6
22261,0,0,75,0,-75
22262,1,0,1,0,-1
22263,0,0,39,0,-39
22264,1,0,66,0,-66
22265,0,0,26,0,-26
22266,1,1,115,1269,1154
22267,1,1,81,1313,1232
22268,1,0,25,0,-25
22269,1,1,75,1363,1288
22270,1,0,44,0,-44
22271,1,1,334,1448,1114
22272,1,1,314,1252,938
22273,1,0,16,0,-16
22274,1,0,43,0,-43
22275,0,0,124,0,-124
22276,1,1,1856,1580,-276
22277,1,1,142,1365,1223
22278,1,0,113,0,-113
22279,1,0,13,0,-13
22280,1,0,14,0,-14
22281,1,0,27,0,-27
22282,0,0,123,0,-123
22283,1,1,295,1503,1208
22284,0,0,50,0,-50
22285,1,1,641,1332,691
22286,1,1,547,1619,1072
22287,1,0,55,0,-55
22288,0,0,42,0,-42
22289,1,1,625,1590,965
22290,0,0,52,0,-52
22291,1,1,1215,1441,226
22292,0,0,17,0,-17
22293,1,0,4,0,-4
22294,1,0,89,0,-89
22295,0,0,109,0,-109
22296,1,0,29,0,-29
22297,1,0,17,0,-17
22298,0,0,6,0,-6
22299,0,0,17,0,-17
22300,0,0,11,0,-11
22301,0,0,13,0,-13
22302,1,0,62,0,-62
22303,0,0,75,0,-75
22304,0,0,31,0,-31
22305,0,0,104,0,-104
22306,0,0,46,0,-46
22307,1,0,1,0,-1
22308,1,0,50,0,-50
22309,0,0,42,0,-42
22310,0,0,5,0,-5
22311,0,0,29,0,-29
22312,1,0,40,0,-40
22313,0,0,25,0,-25
22314,0,0,0,0,0
22315,0,0,17,0,-17
22316,1,1,159,1431,1272
22317,1,0,1,0,-1
22318,1,0,122,0,-122
22319,0,0,45,0,-45
22320,0,0,26,0,-26
22321,1,1,2976,1467,-1509
22322,1,1,255,1274,1019
22323,0,0,2,0,-2
22324,1,0,104,0,-104
22325,1,1,67,1631,1564
22326,1,1,577,2119,1542
22327,1,0,24,0,-24
22328,0,0,101,0,-101
22329,0,0,179,0,-179
22330,0,0,12,0,-12
22331,1,0,27,0,-27
22332,1,0,51,0,-51
22333,1,1,522,1320,798
22334,0,0,3,0,-3
22335,1,0,12,0,-12
22336,1,1,1514,2132,618
22337,1,0,61,0,-61
22338,1,1,843,1584,741
22339,0,0,73,0,-73
22340,1,1,187,1479,1292
22341,0,0,29,0,-29
22342,0,0,3,0,-3
22343,1,0,5,0,-5
22344,0,0,23,0,-23
22345,1,0,202,0,-202
22346,1,0,265,0,-265
22347,0,0,27,0,-27
22348,1,0,19,0,-19
22349,0,0,24,0,-24
22350,1,1,423,1287,864
22351,1,0,13,0,-13
22352,0,0,40,0,-40
22353,1,0,114,0,-114
22354,1,0,12,0,-12
22355,1,0,24,0,-24
22356,0,0,21,0,-21
22357,1,1,224,1479,1255
22358,1,1,347,1347,1000
22359,1,1,544,1399,855
22360,1,0,4,0,-4
22361,0,0,109,0,-109
22362,0,0,39,0,-39
22363,0,0,142,0,-142
22364,1,0,54,0,-54
22365,1,1,528,1418,890
22366,0,0,36,0,-36
22367,0,0,194,0,-194
22368,1,0,20,0,-20
22369,1,0,1,0,-1
22370,0,0,110,0,-110
22371,0,0,71,0,-71
22372,0,0,39,0,-39
22373,1,0,4,0,-4
22374,1,1,401,1278,877
22375,0,0,33,0,-33
22376,1,0,124,0,-124
22377,1,1,459,1396,937
22378,1,1,2363,1391,-972
22379,1,0,139,0,-139
22380,1,1,344,1506,1162
22381,0,0,27,0,-27
22382,0,0,19,0,-19
22383,0,0,120,0,-120
22384,1,1,177,1319,1142
22385,1,1,708,1204,496
22386,1,0,22,0,-22
22387,1,0,127,0,-127
22388,1,1,519,1357,838
22389,1,0,63,0,-63
22390,1,1,635,1502,867
22391,1,0,15,0,-15
22392,0,0,141,0,-141
22393,0,0,0,0,0
22394,0,0,51,0,-51
22395,0,0,44,0,-44
22396,1,0,2,0,-2
22397,0,0,130,0,-130
22398,0,0,15,0,-15
22399,1,1,537,1487,950
22400,1,1,286,1482,1196
22401,1,1,410,2867,2457
22402,0,0,19,0,-19
22403,1,1,299,1441,1142
22404,1,1,2210,1274,-936
22405,0,0,59,0,-59
22406,1,0,48,0,-48
22407,0,0,62,0,-62
22408,1,0,8,0,-8
22409,0,0,40,0,-40
22410,1,0,43,0,-43
22411,0,0,4,0,-4
22412,1,0,21,0,-21
22413,1,1,93,1295,1202
22414,1,1,135,1561,1426
22415,0,0,0,0,0
22416,1,0,2,0,-2
22417,1,0,0,0,0
22418,0,0,28,0,-28
22419,1,1,2231,2061,-170
22420,0,0,15,0,-15
22421,0,0,84,0,-84
22422,1,1,859,1942,1083
22423,1,0,103,0,-103
22424,1,0,11,0,-11
22425,1,1,276,2692,2416
22426,1,0,63,0,-63
22427,0,0,93,0,-93
22428,1,0,154,0,-154
22429,1,0,55,0,-55
22430,1,0,16,0,-16
22431,1,0,73,0,-73
22432,0,0,13,0,-13
22433,0,0,18,0,-18
22434,1,1,181,1562,1381
22435,0,0,24,0,-24
22436,1,1,648,1608,960
22437,1,0,20,0,-20
22438,1,1,446,1303,857
22439,0,0,44,0,-44
22440,1,1,203,1584,1381
22441,0,0,48,0,-48
22442,0,0,66,0,-66
22443,1,0,93,0,-93
22444,1,0,119,0,-119
22445,1,0,49,0,-49
22446,1,1,760,1254,494
22447,1,1,705,1211,506
22448,1,0,162,0,-162
22449,0,0,22,0,-22
22450,1,0,32,0,-32
22451,1,1,316,1294,978
22452,1,1,353,1202,849
22453,1,1,554,1328,774
22454,1,0,262,0,-262
22455,1,1,54,2439,2385
22456,0,0,85,0,-85
22457,1,0,17,0,-17
22458,0,0,2,0,-2
22459,1,0,26,0,-26
22460,0,0,46,0,-46
22461,1,1,124,1228,1104
22462,0,0,119,0,-119
22463,1,0,35,0,-35
22464,1,1,109,1366,1257
22465,1,1,192,1205,1013
22466,1,0,41,0,-41
22467,0,0,43,0,-43
22468,1,1,920,1377,457
22469,1,1,127,1213,1086
22470,1,0,6,0,-6
22471,0,0,145,0,-145
22472,1,0,79,0,-79
22473,1,0,43,0,-43
22474,1,0,41,0,-41
22475,1,0,27,0,-27
22476,1,0,91,0,-91
22477,1,1,887,1806,919
22478,1,1,1143,1661,518
22479,0,0,48,0,-48
22480,0,0,1,0,-1
22481,0,0,14,0,-14
22482,1,1,147,2187,2040
22483,0,0,14,0,-14
22484,1,1,2281,2013,-268
22485,1,1,145,1290,1145
22486,0,0,1,0,-1
22487,1,0,117,0,-117
22488,0,0,102,0,-102
22489,0,0,29,0,-29
22490,1,1,742,1800,1058
22491,0,0,8,0,-8
22492,0,0,30,0,-30
22493,0,0,39,0,-39
22494,0,0,90,0,-90
22495,1,1,681,1729,1048
22496,1,1,167,1215,1048
22497,1,1,440,2540,2100
22498,0,0,22,0,-22
22499,0,0,70,0,-70
22500,0,0,34,0,-34
22501,1,0,65,0,-65
22502,1,0,111,0,-111
22503,0,0,7,0,-7
22504,0,0,52,0,-52
22505,1,0,4,0,-4
22506,1,0,2,0,-2
22507,0,0,2,0,-2
22508,1,1,151,1238,1087
22509,1,0,180,0,-180
22510,1,0,21,0,-21
22511,0,0,41,0,-41
22512,1,0,0,0,0
22513,1,0,6,0,-6
22514,0,0,28,0,-28
22515,1,1,269,1726,1457
22516,1,1,1304,1347,43
22517,1,1,125,2313,2188
22518,1,0,18,0,-18
22519,1,0,109,0,-109
22520,0,0,167,0,-167
22521,0,0,0,0,0
22522,1,0,112,0,-112
22523,1,1,535,3114,2579
22524,1,0,177,0,-177
22525,1,1,832,1499,667
22526,1,0,25,0,-25
22527,1,1,1019,1531,512
22528,1,0,15,0,-15
22529,1,1,408,1408,1000
22530,0,0,20,0,-20
22531,1,1,39,1304,1265
22532,1,0,16,0,-16
22533,1,1,444,1392,948
22534,1,1,1056,1450,394
22535,1,0,53,0,-53
22536,0,0,72,0,-72
22537,1,0,30,0,-30
22538,1,1,694,1228,534
22539,1,0,0,0,0
22540,1,0,6,0,-6
22541,0,0,39,0,-39
22542,0,0,0,0,0
22543,0,0,20,0,-20
22544,1,0,5,0,-5
22545,1,1,667,1287,620
22546,0,0,16,0,-16
22547,0,0,56,0,-56
22548,1,1,114,1855,1741
22549,1,1,586,1549,963
22550,1,1,635,1202,567
22551,1,1,264,1735,1471
22552,0,0,143,0,-143
22553,0,0,353,0,-353
22554,1,0,11,0,-11
22555,0,0,44,0,-44
22556,1,1,393,1219,826
22557,0,0,20,0,-20
22558,0,0,70,0,-70
22559,0,0,120,0,-120
22560,0,0,69,0,-69
22561,1,1,750,1715,965
22562,1,0,117,0,-117
22563,1,0,88,0,-88
22564,1,1,3713,1510,-2203
22565,0,0,31,0,-31
22566,1,0,84,0,-84
22567,1,0,18,0,-18
22568,0,0,306,0,-306
22569,1,0,74,0,-74
22570,1,0,44,0,-44
22571,1,0,112,0,-112
22572,1,0,289,0,-289
22573,0,0,22,0,-22
22574,0,0,97,0,-97
22575,0,0,23,0,-23
22576,1,0,49,0,-49
22577,1,0,23,0,-23
22578,1,1,897,1331,434
22579,1,0,39,0,-39
22580,1,1,1033,1538,505
22581,0,0,70,0,-70
22582,0,0,11,0,-11
22583,1,0,32,0,-32
22584,1,1,408,1323,915
22585,1,1,165,1375,1210
22586,1,1,145,1253,1108
22587,1,0,34,0,-34
22588,0,0,18,0,-18
22589,1,1,186,1949,1763
22590,1,1,1296,1247,-49
22591,1,0,35,0,-35
22592,0,0,17,0,-17
22593,1,0,31,0,-31
22594,1,0,9,0,-9
22595,0,0,60,0,-60
22596,0,0,44,0,-44
22597,1,1,1012,1361,349
22598,0,0,2,0,-2
22599,1,1,247,1462,1215
22600,1,1,1155,1575,420
22601,1,1,385,1998,1613
22602,1,0,133,0,-133
22603,1,0,82,0,-82
22604,0,0,74,0,-74
22605,0,0,86,0,-86
22606,0,0,71,0,-71
22607,1,0,24,0,-24
22608,1,1,1509,1307,-202
22609,1,1,193,1659,1466
22610,1,1,390,1227,837
22611,0,0,23,0,-23
22612,0,0,85,0,-85
22613,0,0,84,0,-84
22614,1,1,1104,1363,259
22615,1,0,38,0,-38
22616,0,0,21,0,-21
22617,1,0,23,0,-23
22618,0,0,331,0,-331
22619,1,1,189,2549,2360
22620,0,0,75,0,-75
22621,1,0,44,0,-44
22622,0,0,99,0,-99
22623,0,0,27,0,-27
22624,1,0,74,0,-74
22625,0,0,37,0,-37
22626,1,0,24,0,-24
22627,1,1,178,1429,1251
22628,0,0,46,0,-46
22629,0,0,54,0,-54
22630,1,0,47,0,-47
22631,0,0,1,0,-1
22632,1,0,10,0,-10
22633,0,0,48,0,-48
22634,1,0,74,0,-74
22635,0,0,3,0,-3
22636,1,1,314,4076,3762
22637,1,1,630,1933,1303
22638,0,0,26,0,-26
22639,1,0,59,0,-59
22640,0,0,24,0,-24
22641,0,0,32,0,-32
22642,1,0,48,0,-48
22643,1,0,54,0,-54
22644,1,1,603,1682,1079
22645,0,0,56,0,-56
22646,1,1,685,1653,968
22647,0,0,102,0,-102
22648,1,1,1010,2173,1163
22649,0,0,41,0,-41
22650,0,0,97,0,-97
22651,0,0,45,0,-45
22652,1,0,78,0,-78
22653,0,0,6,0,-6
22654,1,0,101,0,-101
22655,1,1,759,1248,489
22656,1,0,70,0,-70
22657,1,0,1,0,-1
22658,0,0,2,0,-2
22659,1,0,33,0,-33
22660,1,0,2,0,-2
22661,1,1,732,1845,1113
22662,1,1,483,1656,1173
22663,0,0,32,0,-32
22664,1,0,82,0,-82
22665,1,1,975,1261,286
22666,1,0,150,0,-150
22667,1,1,114,2163,2049
22668,0,0,14,0,-14
22669,1,1,257,2306,2049
22670,1,1,903,2440,1537
22671,1,1,367,1454,1087
22672,1,0,43,0,-43
22673,1,0,113,0,-113
22674,1,1,127,1641,1514
22675,0,0,17,0,-17
22676,1,0,74,0,-74
22677,1,1,118,1460,1342
22678,1,0,62,0,-62
22679,0,0,14,0,-14
22680,1,0,48,0,-48
22681,0,0,22,0,-22
22682,1,1,418,1334,916
22683,0,0,11,0,-11
22684,0,0,71,0,-71
22685,1,0,10,0,-10
22686,1,0,12,0,-12
22687,1,1,230,1674,1444
22688,0,0,23,0,-23
22689,0,0,19,0,-19
22690,0,0,9,0,-9
22691,0,0,56,0,-56
22692,1,0,135,0,-135
22693,0,0,89,0,-89
22694,1,1,551,1276,725
22695,1,1,464,1217,753
22696,0,0,69,0,-69
22697,0,0,5,0,-5
22698,0,0,7,0,-7
22699,1,1,1166,1247,81
22700,1,1,340,1727,1387
22701,1,1,44,1316,1272
22702,0,0,2,0,-2
22703,1,1,1065,1217,152
22704,0,0,26,0,-26
22705,0,0,34,0,-34
22706,1,0,24,0,-24
22707,1,1,311,1332,1021
22708,1,0,7,0,-7
22709,0,0,87,0,-87
22710,1,1,152,1408,1256
22711,1,0,108,0,-108
22712,0,0,56,0,-56
22713,1,1,230,1836,1606
22714,0,0,13,0,-13
22715,1,1,46,2115,2069
22716,1,1,424,1464,1040
22717,0,0,7,0,-7
22718,1,0,66,0,-66
22719,0,0,86,0,-86
22720,1,0,55,0,-55
22721,0,0,109,0,-109
22722,1,1,1055,1387,332
22723,1,0,56,0,-56
22724,1,0,0,0,0
22725,0,0,73,0,-73
22726,0,0,110,0,-110
22727,0,0,27,0,-27
22728,0,0,33,0,-33
22729,1,0,29,0,-29
22730,1,1,77,1292,1215
22731,0,0,9,0,-9
22732,0,0,63,0,-63
22733,1,0,10,0,-10
22734,1,1,45,1284,1239
22735,1,1,191,1477,1286
22736,1,1,54,1215,1161
22737,0,0,87,0,-87
22738,1,0,1,0,-1
22739,1,1,615,1367,752
22740,0,0,100,0,-100
22741,1,1,321,1649,1328
22742,0,0,1,0,-1
22743,1,0,5,0,-5
22744,1,0,119,0,-119
22745,0,0,1,0,-1
22746,0,0,23,0,-23
22747,0,0,61,0,-61
22748,1,1,69,1697,1628
22749,0,0,28,0,-28
22750,0,0,32,0,-32
22751,1,0,5,0,-5
22752,0,0,13,0,-13
22753,1,1,130,3045,2915
22754,0,0,33,0,-33
22755,1,0,105,0,-105
22756,1,1,46,1248,1202
22757,1,0,74,0,-74
22758,1,0,52,0,-52
22759,1,0,17,0,-17
22760,0,0,10,0,-10
22761,1,1,356,2272,1916
22762,1,1,1641,1390,-251
22763,1,0,14,0,-14
22764,1,0,102,0,-102
22765,1,1,297,1408,1111
22766,0,0,24,0,-24
22767,1,1,846,1221,375
22768,1,1,41,1544,1503
22769,0,0,33,0,-33
22770,1,0,79,0,-79
22771,0,0,4,0,-4
22772,0,0,2,0,-2
22773,0,0,5,0,-5
22774,1,0,38,0,-38
22775,1,0,13,0,-13
22776,0,0,67,0,-67
22777,0,0,3,0,-3
22778,0,0,143,0,-143
22779,1,1,490,1735,1245
22780,1,0,78,0,-78
22781,1,1,1522,2155,633
22782,1,0,144,0,-144
22783,0,0,73,0,-73
22784,0,0,26,0,-26
22785,1,1,323,1517,1194
22786,1,0,22,0,-22
22787,0,0,1,0,-1
22788,1,1,248,1338,1090
22789,1,0,14,0,-14
22790,1,1,505,1299,794
22791,1,1,1224,1627,403
22792,1,1,940,1228,288
22793,0,0,81,0,-81
22794,0,0,91,0,-91
22795,1,1,489,1259,770
22796,0,0,105,0,-105
22797,1,1,1013,1642,629
22798,1,1,127,1432,1305
22799,0,0,32,0,-32
22800,1,1,355,1318,963
22801,1,1,339,1753,1414
22802,0,0,33,0,-33
22803,1,1,78,2099,2021
22804,0,0,26,0,-26
22805,1,1,955,1576,621
22806,1,1,359,1781,1422
22807,1,1,462,1205,743
22808,1,0,13,0,-13
22809,1,1,277,1218,941
22810,0,0,82,0,-82
22811,1,0,93,0,-93
22812,1,0,36,0,-36
22813,0,0,25,0,-25
22814,0,0,25,0,-25
22815,1,1,368,2055,1687
22816,1,1,85,1365,1280
22817,1,0,153,0,-153
22818,0,0,7,0,-7
22819,1,0,10,0,-10
22820,1,1,306,1305,999
22821,1,0,105,0,-105
22822,0,0,16,0,-16
22823,1,1,247,1622,1375
22824,0,0,100,0,-100
22825,1,1,207,1215,1008
22826,0,0,21,0,-21
22827,1,0,36,0,-36
22828,0,0,188,0,-188
22829,1,0,31,0,-31
22830,1,0,34,0,-34
22831,0,0,56,0,-56
22832,1,1,325,1251,926
22833,1,1,188,1729,1541
22834,1,1,835,1520,685
22835,0,0,21,0,-21
22836,1,1,897,1267,370
22837,0,0,23,0,-23
22838,1,1,729,1337,608
22839,1,0,0,0,0
22840,1,1,113,3514,3401
22841,0,0,10,0,-10
22842,0,0,9,0,-9
22843,0,0,156,0,-156
22844,1,0,199,0,-199
22845,1,1,294,1245,951
22846,1,1,705,1329,624
22847,1,0,56,0,-56
22848,1,1,958,1553,595
22849,0,0,25,0,-25
22850,0,0,21,0,-21
22851,1,0,32,0,-32
22852,0,0,8,0,-8
22853,1,1,40,1284,1244
22854,1,1,1280,1232,-48
22855,1,0,36,0,-36
22856,1,0,116,0,-116
22857,0,0,134,0,-134
22858,1,1,120,1406,1286
22859,1,1,164,1575,1411
22860,1,1,844,1552,708
22861,0,0,48,0,-48
22862,0,0,11,0,-11
22863,1,0,84,0,-84
22864,1,0,27,0,-27
22865,0,0,141,0,-141
22866,0,0,102,0,-102
22867,0,0,38,0,-38
22868,1,1,146,1320,1174
22869,0,0,28,0,-28
22870,1,1,1154,1491,337
22871,0,0,125,0,-125
22872,1,0,2,0,-2
22873,1,0,8,0,-8
22874,1,0,7,0,-7
22875,1,1,801,1364,563
22876,0,0,112,0,-112
22877,1,0,21,0,-21
22878,1,1,104,1225,1121
22879,1,1,364,1485,1121
22880,1,0,67,0,-67
22881,1,1,1040,1901,861
22882,0,0,12,0,-12
22883,0,0,43,0,-43
22884,1,1,73,2352,2279
22885,1,1,221,2219,1998
22886,1,0,87,0,-87
22887,1,1,240,1376,1136
22888,1,0,67,0,-67
22889,0,0,18,0,-18
22890,1,0,20,0,-20
22891,0,0,77,0,-77
22892,1,0,42,0,-42
22893,1,0,46,0,-46
22894,0,0,6,0,-6
22895,1,0,10,0,-10
22896,0,0,56,0,-56
22897,1,1,736,2108,1372
22898,1,1,163,1634,1471
22899,1,1,778,1234,456
22900,1,1,451,1283,832
22901,0,0,63,0,-63
22902,1,1,434,1340,906
22903,1,1,71,1264,1193
22904,1,0,140,0,-140
22905,0,0,7,0,-7
22906,1,0,2,0,-2
22907,1,0,8,0,-8
22908,1,1,213,2181,1968
22909,0,0,55,0,-55
22910,0,0,20,0,-20
22911,0,0,30,0,-30
22912,1,0,41,0,-41
22913,1,1,2290,1733,-557
22914,1,0,21,0,-21
22915,1,0,43,0,-43
22916,0,0,9,0,-9
22917,0,0,2,0,-2
22918,1,0,53,0,-53
22919,0,0,23,0,-23
22920,1,0,23,0,-23
22921,1,0,24,0,-24
22922,1,1,164,2474,2310
22923,1,0,15,0,-15
22924,0,0,49,0,-49
22925,1,1,977,1240,263
22926,1,1,550,2075,1525
22927,1,0,3,0,-3
22928,0,0,24,0,-24
22929,0,0,3,0,-3
22930,0,0,55,0,-55
22931,1,1,475,2093,1618
22932,1,1,3082,1395,-1687
22933,0,0,11,0,-11
22934,0,0,84,0,-84
22935,1,1,502,1618,1116
22936,1,1,301,1558,1257
22937,1,0,4,0,-4
22938,1,0,72,0,-72
22939,1,0,167,0,-167
22940,1,0,259,0,-259
22941,1,1,56,1817,1761
22942,0,0,15,0,-15
22943,1,0,115,0,-115
22944,0,0,106,0,-106
22945,0,0,34,0,-34
22946,0,0,90,0,-90
22947,0,0,42,0,-42
22948,0,0,20,0,-20
22949,0,0,45,0,-45
22950,1,1,119,2798,2679
22951,0,0,58,0,-58
22952,1,0,2,0,-2
22953,1,0,162,0,-162
22954,1,1,602,2111,1509
22955,0,0,0,0,0
22956,1,0,23,0,-23
22957,0,0,27,0,-27
22958,0,0,52,0,-52
22959,1,1,629,1269,640
22960,0,0,12,0,-12
22961,1,0,9,0,-9
22962,1,1,74,1550,1476
22963,1,1,183,1485,1302
22964,1,0,234,0,-234
22965,0,0,47,0,-47
22966,1,0,45,0,-45
22967,0,0,19,0,-19
22968,1,0,88,0,-88
22969,1,0,1,0,-1
22970,1,1,225,1902,1677
22971,0,0,11,0,-11
22972,1,0,109,0,-109
22973,1,1,166,1435,1269
22974,1,1,322,1653,1331
22975,0,0,27,0,-27
22976,1,0,22,0,-22
22977,1,0,18,0,-18
22978,1,1,555,1453,898
22979,0,0,87,0,-87
22980,1,1,97,1261,1164
22981,1,1,481,1347,866
22982,1,1,2254,1221,-1033
22983,1,0,4,0,-4
22984,1,1,221,1283,1062
22985,0,0,14,0,-14
22986,0,0,59,0,-59
22987,1,1,953,1209,256
22988,0,0,0,0,0
22989,1,0,25,0,-25
22990,1,1,224,1260,1036
22991,0,0,10,0,-10
22992,1,1,471,1279,808
22993,0,0,35,0,-35
22994,0,0,0,0,0
22995,1,1,368,1498,1130
22996,1,0,104,0,-104
22997,1,0,82,0,-82
22998,1,0,145,0,-145
22999,1,0,40,0,-40
23000,0,0,248,0,-248
23001,1,0,47,0,-47
23002,1,1,992,1933,941
23003,1,1,597,1735,1138
23004,1,0,5,0,-5
23005,0,0,77,0,-77
23006,0,0,7,0,-7
23007,0,0,77,0,-77
23008,1,1,504,1334,830
23009,1,1,656,1258,602
23010,1,0,1,0,-1
23011,0,0,153,0,-153
23012,0,0,5,0,-5
23013,0,0,17,0,-17
23014,1,1,363,1243,880
23015,1,0,78,0,-78
23016,0,0,71,0,-71
23017,1,0,76,0,-76
23018,1,1,84,2735,2651
23019,1,0,18,0,-18
23020,0,0,26,0,-26
23021,0,0,100,0,-100
23022,1,1,949,1630,681
23023,1,0,76,0,-76
23024,1,0,52,0,-52
23025,1,1,403,2493,2090
23026,0,0,50,0,-50
23027,1,1,967,1611,644
23028,0,0,23,0,-23
23029,1,1,202,1575,1373
23030,0,0,58,0,-58
23031,1,1,114,1333,1219
23032,0,0,78,0,-78
23033,0,0,2,0,-2
23034,1,1,265,1909,1644
23035,1,1,595,1288,693
23036,1,0,7,0,-7
23037,1,0,15,0,-15
23038,0,0,37,0,-37
23039,1,1,2822,1449,-1373
23040,1,0,28,0,-28
23041,1,0,99,0,-99
23042,0,0,23,0,-23
23043,1,1,18,1343,1325
23044,0,0,18,0,-18
23045,1,1,698,1332,634
23046,0,0,50,0,-50
23047,1,1,865,1447,582
23048,0,0,41,0,-41
23049,1,1,103,1541,1438
23050,1,1,443,2590,2147
23051,0,0,4,0,-4
23052,1,0,12,0,-12
23053,1,0,13,0,-13
23054,1,0,85,0,-85
23055,0,0,0,0,0
23056,1,0,141,0,-141
23057,1,0,3,0,-3
23058,1,1,423,1220,797
23059,1,0,106,0,-106
23060,1,1,342,1318,976
23061,1,1,511,1465,954
23062,1,0,98,0,-98
23063,1,0,10,0,-10
23064,0,0,28,0,-28
23065,1,0,71,0,-71
23066,0,0,4,0,-4
23067,1,0,102,0,-102
23068,1,1,1983,1255,-728
23069,0,0,98,0,-98
23070,0,0,69,0,-69
23071,1,0,30,0,-30
23072,1,0,18,0,-18
23073,1,0,75,0,-75
23074,0,0,155,0,-155
23075,1,1,588,1350,762
23076,1,0,5,0,-5
23077,0,0,13,0,-13
23078,0,0,84,0,-84
23079,1,1,213,1206,993
23080,1,1,1055,1406,351
23081,0,0,28,0,-28
23082,1,1,521,1629,1108
23083,0,0,59,0,-59
23084,0,0,9,0,-9
23085,1,1,592,1505,913
23086,0,0,13,0,-13
23087,1,1,385,1259,874
23088,1,1,771,1340,569
23089,1,0,0,0,0
23090,1,0,7,0,-7
23091,0,0,9,0,-9
23092,0,0,21,0,-21
23093,1,0,36,0,-36
23094,0,0,96,0,-96
23095,1,0,5,0,-5
23096,0,0,46,0,-46
23097,1,1,143,2013,1870
23098,1,0,4,0,-4
23099,1,0,61,0,-61
23100,0,0,119,0,-119
23101,1,1,89,1392,1303
23102,0,0,98,0,-98
23103,1,1,192,1574,1382
23104,0,0,95,0,-95
23105,0,0,32,0,-32
23106,1,0,169,0,-169
23107,1,1,596,1223,627
23108,1,1,795,1452,657
23109,0,0,52,0,-52
23110,0,0,34,0,-34
23111,1,1,437,1527,1090
23112,1,0,72,0,-72
23113,1,1,289,1580,1291
23114,0,0,14,0,-14
23115,0,0,63,0,-63
23116,0,0,9,0,-9
23117,1,1,2508,1265,-1243
23118,0,0,51,0,-51
23119,1,1,861,1461,600
23120,0,0,150,0,-150
23121,0,0,173,0,-173
23122,1,0,179,0,-179
23123,1,0,16,0,-16
23124,1,0,2,0,-2
23125,1,1,167,1852,1685
23126,1,1,350,1633,1283
23127,0,0,19,0,-19
23128,1,1,310,1326,1016
23129,0,0,24,0,-24
23130,0,0,27,0,-27
23131,0,0,192,0,-192
23132,1,1,184,1227,1043
23133,0,0,36,0,-36
23134,0,0,36,0,-36
23135,1,1,493,1424,931
23136,0,0,5,0,-5
23137,0,0,36,0,-36
23138,1,0,1,0,-1
23139,1,0,49,0,-49
23140,0,0,4,0,-4
23141,1,1,569,1232,663
23142,1,0,39,0,-39
23143,1,1,224,1488,1264
23144,1,1,179,2399,2220
23145,1,1,852,1841,989
23146,0,0,347,0,-347
23147,1,1,327,1363,1036
23148,1,1,1086,1237,151
23149,1,1,2239,1675,-564
23150,1,1,263,1337,1074
23151,0,0,180,0,-180
23152,1,0,28,0,-28
23153,1,1,352,1311,959
23154,0,0,46,0,-46
23155,1,1,669,1601,932
23156,1,1,62,1896,1834
23157,1,1,679,1601,922
23158,1,1,331,1351,1020
23159,0,0,2,0,-2
23160,1,0,3,0,-3
23161,0,0,87,0,-87
23162,1,0,65,0,-65
23163,0,0,21,0,-21
23164,1,0,31,0,-31
23165,0,0,25,0,-25
23166,1,0,92,0,-92
23167,1,1,859,1296,437
23168,0,0,12,0,-12
23169,1,1,211,1337,1126
23170,0,0,112,0,-112
23171,0,0,39,0,-39
23172,1,0,99,0,-99
23173,0,0,37,0,-37
23174,1,1,736,1247,511
23175,1,0,96,0,-96
23176,0,0,19,0,-19
23177,0,0,33,0,-33
23178,1,1,1627,1278,-349
23179,0,0,31,0,-31
23180,1,1,141,1523,1382
23181,0,0,70,0,-70
23182,1,0,67,0,-67
23183,1,0,96,0,-96
23184,1,0,27,0,-27
23185,1,0,19,0,-19
23186,1,1,1080,1320,240
23187,1,0,15,0,-15
23188,0,0,8,0,-8
23189,0,0,128,0,-128
23190,0,0,53,0,-53
23191,0,0,20,0,-20
23192,0,0,13,0,-13
23193,1,0,52,0,-52
23194,1,1,891,1262,371
23195,0,0,31,0,-31
23196,0,0,10,0,-10
23197,1,0,7,0,-7
23198,1,0,33,0,-33
23199,1,0,41,0,-41
23200,1,1,128,1533,1405
23201,1,1,422,1210,788
23202,1,0,10,0,-10
23203,1,1,294,1843,1549
23204,1,0,45,0,-45
23205,1,1,175,1261,1086
23206,1,1,126,1423,1297
23207,1,1,79,1588,1509
23208,0,0,20,0,-20
23209,0,0,56,0,-56
23210,0,0,22,0,-22
23211,1,0,6,0,-6
23212,0,0,68,0,-68
23213,0,0,14,0,-14
23214,1,0,24,0,-24
23215,1,1,254,1624,1370
23216,0,0,87,0,-87
23217,1,0,32,0,-32
23218,1,1,928,1474,546
23219,0,0,7,0,-7
23220,1,1,2372,1342,-1030
23221,1,0,69,0,-69
23222,0,0,4,0,-4
23223,1,1,193,1293,1100
23224,0,0,6,0,-6
23225,1,0,104,0,-104
23226,1,1,405,1739,1334
23227,1,0,0,0,0
23228,1,0,50,0,-50
23229,0,0,54,0,-54
23230,0,0,57,0,-57
23231,1,1,778,2201,1423
23232,0,0,99,0,-99
23233,0,0,31,0,-31
23234,1,1,63,1554,1491
23235,0,0,27,0,-27
23236,1,1,375,1302,927
23237,1,0,101,0,-101
23238,1,0,64,0,-64
23239,1,0,38,0,-38
23240,0,0,45,0,-45
23241,0,0,42,0,-42
23242,1,1,1351,1230,-121
23243,1,1,1178,1574,396
23244,0,0,68,0,-68
23245,1,0,41,0,-41
23246,1,1,58,1637,1579
23247,1,1,454,1363,909
23248,1,0,70,0,-70
23249,1,0,26,0,-26
23250,1,0,19,0,-19
23251,1,0,67,0,-67
23252,0,0,31,0,-31
23253,0,0,82,0,-82
23254,1,1,353,1447,1094
23255,1,0,158,0,-158
23256,0,0,54,0,-54
23257,1,0,24,0,-24
23258,0,0,18,0,-18
23259,1,0,170,0,-170
23260,0,0,60,0,-60
23261,1,0,0,0,0
23262,0,0,96,0,-96
23263,0,0,4,0,-4
23264,1,0,11,0,-11
23265,1,0,74,0,-74
23266,0,0,18,0,-18
23267,1,1,267,1442,1175
23268,1,0,29,0,-29
23269,1,0,48,0,-48
23270,1,0,103,0,-103
23271,1,1,1308,1230,-78
23272,0,0,32,0,-32
23273,1,1,485,1610,1125
23274,1,1,1905,1519,-386
23275,1,1,1665,1663,-2
23276,1,1,579,1200,621
23277,0,0,64,0,-64
23278,0,0,12,0,-12
23279,1,1,897,1925,1028
23280,0,0,10,0,-10
23281,0,0,23,0,-23
23282,1,0,98,0,-98
23283,1,0,44,0,-44
23284,0,0,22,0,-22
23285,1,1,59,1297,1238
23286,1,0,20,0,-20
23287,1,1,184,1414,1230
23288,1,0,1,0,-1
23289,1,0,48,0,-48
23290,1,0,22,0,-22
23291,0,0,59,0,-59
23292,0,0,44,0,-44
23293,1,0,29,0,-29
23294,0,0,62,0,-62
23295,1,1,1400,1207,-193
23296,1,0,21,0,-21
23297,1,0,179,0,-179
23298,0,0,141,0,-141
23299,0,0,46,0,-46
23300,0,0,45,0,-45
23301,1,1,1001,1211,210
23302,1,1,147,1449,1302
23303,0,0,38,0,-38
23304,1,1,615,1661,1046
23305,0,0,11,0,-11
23306,1,1,424,1231,807
23307,0,0,2,0,-2
23308,0,0,22,0,-22
23309,0,0,11,0,-11
23310,1,1,271,1894,1623
23311,0,0,81,0,-81
23312,0,0,8,0,-8
23313,1,0,42,0,-42
23314,0,0,52,0,-52
23315,1,0,41,0,-41
23316,1,0,0,0,0
23317,1,1,661,1545,884
23318,1,1,1079,1223,144
23319,0,0,66,0,-66
23320,1,0,47,0,-47
23321,1,1,31,1462,1431
23322,1,1,1009,1218,209
23323,1,1,507,1220,713
23324,1,1,861,1275,414
23325,1,0,59,0,-59
23326,1,1,698,1236,538
23327,0,0,23,0,-23
23328,0,0,62,0,-62
23329,0,0,13,0,-13
23330,1,0,9,0,-9
23331,1,1,103,1281,1178
23332,1,0,2,0,-2
23333,1,0,32,0,-32
23334,0,0,28,0,-28
23335,1,1,432,1718,1286
23336,1,0,103,0,-103
23337,1,0,4,0,-4
23338,1,0,111,0,-111
23339,1,0,31,0,-31
23340,0,0,14,0,-14
23341,1,1,669,2932,2263
23342,1,0,129,0,-129
23343,1,0,22,0,-22
23344,0,0,15,0,-15
23345,1,0,71,0,-71
23346,1,0,21,0,-21
23347,1,0,33,0,-33
23348,0,0,33,0,-33
23349,0,0,20,0,-20
23350,0,0,17,0,-17
23351,0,0,54,0,-54
23352,1,0,36,0,-36
23353,1,0,51,0,-51
23354,0,0,74,0,-74
23355,0,0,27,0,-27
23356,1,1,365,1403,1038
23357,1,1,389,1416,1027
23358,1,0,96,0,-96
23359,1,0,17,0,-17
23360,1,1,604,1379,775
23361,1,1,1884,1788,-96
23362,0,0,12,0,-12
23363,1,1,1155,1240,85
23364,1,0,7,0,-7
23365,1,1,75,1664,1589
23366,0,0,13,0,-13
23367,0,0,11,0,-11
23368,0,0,3,0,-3
23369,1,0,218,0,-218
23370,1,0,46,0,-46
23371,0,0,42,0,-42
23372,1,0,37,0,-37
23373,1,1,37,1661,1624
23374,1,1,168,1590,1422
23375,1,0,53,0,-53
23376,1,0,32,0,-32
23377,0,0,17,0,-17
23378,0,0,53,0,-53
23379,1,0,49,0,-49
23380,1,1,746,1389,643
23381,0,0,0,0,0
23382,0,0,9,0,-9
23383,0,0,40,0,-40
23384,0,0,9,0,-9
23385,1,1,332,1322,990
23386,0,0,124,0,-124
23387,1,0,78,0,-78
23388,1,1,1001,1270,269
23389,0,0,195,0,-195
23390,1,1,264,1367,1103
23391,1,1,241,1253,1012
23392,1,1,292,1593,1301
23393,0,0,10,0,-10
23394,1,1,261,1682,1421
23395,0,0,31,0,-31
23396,1,1,156,1296,1140
23397,0,0,58,0,-58
23398,1,0,30,0,-30
23399,1,1,827,1395,568
23400,0,0,46,0,-46
23401,0,0,6,0,-6
23402,1,1,607,1259,652
23403,0,0,4,0,-4
23404,1,0,148,0,-148
23405,0,0,30,0,-30
23406,1,1,353,1710,1357
23407,1,1,17,1579,1562
23408,0,0,5,0,-5
23409,1,0,8,0,-8
23410,1,1,540,1460,920
23411,1,1,34,1219,1185
23412,1,1,34,1383,1349
23413,0,0,72,0,-72
23414,0,0,26,0,-26
23415,1,1,908,2061,1153
23416,0,0,34,0,-34
23417,1,0,23,0,-23
23418,1,1,934,1273,339
23419,1,1,2599,1278,-1321
23420,1,1,258,1820,1562
23421,1,0,50,0,-50
23422,0,0,75,0,-75
23423,1,1,91,1207,1116
23424,1,1,2163,1348,-815
23425,0,0,16,0,-16
23426,1,0,3,0,-3
23427,0,0,2,0,-2
23428,0,0,131,0,-131
23429,0,0,123,0,-123
23430,0,0,10,0,-10
23431,0,0,55,0,-55
23432,1,1,60,1417,1357
23433,1,0,69,0,-69
23434,1,1,660,1930,1270
23435,1,0,12,0,-12
23436,0,0,4,0,-4
23437,1,0,62,0,-62
23438,1,0,7,0,-7
23439,1,0,6,0,-6
23440,1,0,2,0,-2
23441,1,0,12,0,-12
23442,1,0,89,0,-89
23443,1,0,93,0,-93
23444,1,0,114,0,-114
23445,1,0,1,0,-1
23446,1,1,497,2772,2275
23447,0,0,49,0,-49
23448,0,0,13,0,-13
23449,0,0,41,0,-41
23450,1,0,20,0,-20
23451,1,0,24,0,-24
23452,1,1,168,1220,1052
23453,1,0,8,0,-8
23454,1,1,347,1381,1034
23455,1,1,1677,1263,-414
23456,1,0,16,0,-16
23457,0,0,10,0,-10
23458,1,0,18,0,-18
23459,0,0,7,0,-7
23460,0,0,49,0,-49
23461,0,0,58,0,-58
23462,0,0,4,0,-4
23463,1,0,12,0,-12
23464,1,1,1373,1314,-59
23465,0,0,121,0,-121
23466,0,0,111,0,-111
23467,1,1,623,1333,710
23468,0,0,9,0,-9
23469,1,1,521,1852,1331
23470,1,0,145,0,-145
23471,0,0,38,0,-38
23472,0,0,83,0,-83
23473,0,0,44,0,-44
23474,1,1,47,1399,1352
23475,0,0,50,0,-50
23476,0,0,85,0,-85
23477,0,0,43,0,-43
23478,1,1,664,1679,1015
23479,1,0,13,0,-13
23480,0,0,27,0,-27
23481,1,0,24,0,-24
23482,1,1,359,1529,1170
23483,1,1,68,1645,1577
23484,1,0,36,0,-36
23485,0,0,11,0,-11
23486,0,0,39,0,-39
23487,1,1,250,1301,1051
23488,1,1,879,1264,385
23489,1,1,390,1388,998
23490,0,0,15,0,-15
23491,1,1,433,1360,927
23492,1,0,5,0,-5
23493,0,0,52,0,-52
23494,1,0,20,0,-20
23495,0,0,9,0,-9
23496,1,0,26,0,-26
23497,0,0,19,0,-19
23498,1,0,199,0,-199
23499,1,1,850,1568,718
23500,1,0,52,0,-52
23501,1,1,224,1285,1061
23502,1,1,211,3184,2973
23503,0,0,145,0,-145
23504,1,1,503,1309,806
23505,0,0,78,0,-78
23506,1,1,1482,1432,-50
23507,1,0,0,0,0
23508,1,1,639,1213,574
23509,1,1,805,1957,1152
23510,1,1,269,2560,2291
23511,1,0,17,0,-17
23512,1,1,256,1287,1031
23513,0,0,36,0,-36
23514,0,0,25,0,-25
23515,1,0,77,0,-77
23516,1,0,46,0,-46
23517,1,1,331,1255,924
23518,0,0,22,0,-22
23519,1,1,550,1457,907
23520,1,0,83,0,-83
23521,0,0,27,0,-27
23522,1,1,576,1228,652
23523,1,0,3,0,-3
23524,0,0,124,0,-124
23525,0,0,16,0,-16
23526,0,0,143,0,-143
23527,1,0,19,0,-19
23528,1,1,475,1487,1012
23529,0,0,36,0,-36
23530,1,0,16,0,-16
23531,1,1,343,1840,1497
23532,1,1,628,1370,742
23533,1,1,102,1256,1154
23534,1,0,59,0,-59
23535,0,0,7,0,-7
23536,1,0,7,0,-7
23537,1,0,0,0,0
23538,1,1,566,1222,656
23539,1,1,1143,1300,157
23540,0,0,67,0,-67
23541,0,0,85,0,-85
23542,1,1,863,2125,1262
23543,0,0,14,0,-14
23544,1,1,1118,1228,110
23545,1,0,16,0,-16
23546,1,1,263,1348,1085
23547,1,0,238,0,-238
23548,0,0,91,0,-91
23549,1,1,215,1233,1018
23550,0,0,14,0,-14
23551,0,0,37,0,-37
23552,0,0,63,0,-63
23553,0,0,17,0,-17
23554,1,1,181,1243,1062
23555,0,0,79,0,-79
23556,1,0,21,0,-21
23557,1,1,1479,1202,-277
23558,1,0,17,0,-17
23559,1,1,156,1721,1565
23560,0,0,18,0,-18
23561,0,0,11,0,-11
23562,0,0,112,0,-112
23563,1,1,181,1212,1031
23564,0,0,96,0,-96
23565,0,0,89,0,-89
23566,1,1,706,1372,666
23567,0,0,108,0,-108
23568,1,1,101,2349,2248
23569,1,1,42,2029,1987
23570,1,1,97,1506,1409
23571,0,0,81,0,-81
23572,0,0,39,0,-39
23573,0,0,94,0,-94
23574,1,1,1064,1854,790
23575,1,1,988,1450,462
23576,1,1,23,1766,1743
23577,1,1,2837,1970,-867
23578,1,1,457,1389,932
23579,1,0,6,0,-6
23580,1,1,347,1368,1021
23581,1,1,148,1341,1193
23582,1,0,3,0,-3
23583,1,1,563,3566,3003
23584,1,0,80,0,-80
23585,0,0,29,0,-29
23586,0,0,181,0,-181
23587,0,0,178,0,-178
23588,1,1,111,1231,1120
23589,0,0,25,0,-25
23590,1,0,27,0,-27
23591,1,1,660,1841,1181
23592,0,0,58,0,-58
23593,1,0,31,0,-31
23594,0,0,13,0,-13
23595,0,0,16,0,-16
23596,0,0,17,0,-17
23597,1,1,476,1353,877
23598,0,0,23,0,-23
23599,1,0,6,0,-6
23600,0,0,99,0,-99
23601,1,1,378,2205,1827
23602,1,1,746,1513,767
23603,1,1,410,1241,831
23604,1,1,136,1218,1082
23605,0,0,5,0,-5
23606,1,0,7,0,-7
23607,1,1,99,1258,1159
23608,0,0,57,0,-57
23609,1,1,183,1240,1057
23610,1,0,26,0,-26
23611,1,0,18,0,-18
23612,0,0,24,0,-24
23613,1,0,62,0,-62
23614,1,0,175,0,-175
23615,1,0,98,0,-98
23616,1,0,46,0,-46
23617,0,0,33,0,-33
23618,1,0,64,0,-64
23619,0,0,210,0,-210
23620,0,0,7,0,-7
23621,1,0,98,0,-98
23622,1,1,911,1548,637
23623,0,0,12,0,-12
23624,0,0,47,0,-47
23625,0,0,3,0,-3
23626,1,1,173,1511,1338
23627,0,0,22,0,-22
23628,1,1,194,1978,1784
23629,1,0,64,0,-64
23630,1,1,587,1629,1042
23631,1,0,0,0,0
23632,0,0,9,0,-9
23633,1,0,28,0,-28
23634,1,1,729,1274,545
23635,1,0,114,0,-114
23636,1,0,94,0,-94
23637,1,0,28,0,-28
23638,0,0,17,0,-17
23639,1,1,582,1719,1137
23640,1,0,144,0,-144
23641,0,0,10,0,-10
23642,1,1,248,1365,1117
23643,0,0,13,0,-13
23644,0,0,35,0,-35
23645,0,0,25,0,-25
23646,1,0,23,0,-23
23647,0,0,88,0,-88
23648,0,0,4,0,-4
23649,1,0,43,0,-43
23650,1,1,375,1219,844
23651,0,0,62,0,-62
23652,1,1,543,3924,3381
23653,1,0,84,0,-84
23654,1,0,57,0,-57
23655,1,1,252,1502,1250
23656,1,0,156,0,-156
23657,1,1,600,1698,1098
23658,0,0,38,0,-38
23659,1,0,92,0,-92
23660,1,1,1781,1548,-233
23661,1,0,1,0,-1
23662,1,1,513,1227,714
23663,1,0,16,0,-16
23664,0,0,43,0,-43
23665,1,1,940,1228,288
23666,1,0,62,0,-62
23667,0,0,34,0,-34
23668,0,0,30,0,-30
23669,1,1,833,1455,622
23670,1,1,1274,2234,960
23671,1,0,39,0,-39
23672,1,1,554,1329,775
23673,1,1,941,1339,398
23674,1,0,90,0,-90
23675,0,0,82,0,-82
23676,1,1,895,1862,967
23677,1,0,16,0,-16
23678,1,0,24,0,-24
23679,1,0,65,0,-65
23680,1,0,120,0,-120
23681,0,0,65,0,-65
23682,0,0,41,0,-41
23683,0,0,9,0,-9
23684,0,0,62,0,-62
23685,1,1,721,1334,613
23686,1,1,200,1391,1191
23687,1,0,86,0,-86
23688,1,1,337,1544,1207
23689,0,0,47,0,-47
23690,1,1,1832,2174,342
23691,0,0,192,0,-192
23692,0,0,152,0,-152
23693,0,0,24,0,-24
23694,1,1,1371,3501,2130
23695,0,0,23,0,-23
23696,1,0,6,0,-6
23697,1,1,67,1369,1302
23698,0,0,68,0,-68
23699,1,1,414,1297,883
23700,0,0,188,0,-188
23701,0,0,33,0,-33
23702,1,1,509,1254,745
23703,0,0,78,0,-78
23704,1,1,579,1586,1007
23705,0,0,15,0,-15
23706,1,1,1316,1710,394
23707,1,0,9,0,-9
23708,1,0,4,0,-4
23709,1,1,189,1227,1038
23710,0,0,78,0,-78
23711,1,1,84,1326,1242
23712,1,1,282,1509,1227
23713,1,1,234,1334,1100
23714,1,1,180,1381,1201
23715,1,1,357,1290,933
23716,1,0,13,0,-13
23717,1,1,298,1626,1328
23718,1,1,723,1281,558
23719,1,1,547,1236,689
23720,0,0,1,0,-1
23721,1,1,569,3648,3079
23722,1,0,29,0,-29
23723,1,0,0,0,0
23724,1,1,61,1897,1836
23725,1,1,359,1311,952
23726,1,1,426,1672,1246
23727,1,0,39,0,-39
23728,1,1,935,1556,621
23729,1,0,118,0,-118
23730,1,1,693,1383,690
23731,0,0,9,0,-9
23732,1,1,269,1329,1060
23733,1,1,100,1697,1597
23734,1,1,621,1215,594
23735,0,0,67,0,-67
23736,0,0,131,0,-131
23737,1,0,1,0,-1
23738,0,0,12,0,-12
23739,0,0,97,0,-97
23740,1,1,138,1396,1258
23741,1,0,23,0,-23
23742,1,0,260,0,-260
23743,0,0,16,0,-16
23744,1,1,106,1943,1837
23745,1,0,23,0,-23
23746,1,1,929,1438,509
23747,1,0,20,0,-20
23748,1,1,209,1440,1231
23749,1,0,87,0,-87
23750,1,0,19,0,-19
23751,1,0,156,0,-156
23752,0,0,53,0,-53
23753,0,0,16,0,-16
23754,1,0,126,0,-126
23755,0,0,12,0,-12
23756,1,0,157,0,-157
23757,0,0,9,0,-9
23758,0,0,6,0,-6
23759,0,0,95,0,-95
23760,0,0,60,0,-60
23761,0,0,3,0,-3
23762,0,0,12,0,-12
23763,1,1,869,1955,1086
23764,1,0,11,0,-11
23765,1,1,530,1271,741
23766,1,0,30,0,-30
23767,1,0,97,0,-97
23768,1,0,175,0,-175
23769,1,0,122,0,-122
23770,1,1,424,1977,1553
23771,0,0,19,0,-19
23772,1,1,1050,2074,1024
23773,0,0,56,0,-56
23774,1,1,579,1252,673
23775,1,1,419,1287,868
23776,1,0,23,0,-23
23777,1,0,1,0,-1
23778,1,1,152,1272,1120
23779,0,0,13,0,-13
23780,1,1,1212,1418,206
23781,1,0,121,0,-121
23782,1,0,13,0,-13
23783,1,0,127,0,-127
23784,0,0,37,0,-37
23785,1,0,2,0,-2
23786,1,1,152,1404,1252
23787,0,0,13,0,-13
23788,0,0,64,0,-64
23789,1,1,153,1226,1073
23790,0,0,7,0,-7
23791,0,0,10,0,-10
23792,0,0,48,0,-48
23793,1,0,33,0,-33
23794,0,0,44,0,-44
23795,0,0,43,0,-43
23796,1,1,86,1461,1375
23797,1,1,486,1323,837
23798,1,1,965,1304,339
23799,0,0,132,0,-132
23800,1,0,26,0,-26
23801,1,0,22,0,-22
23802,1,0,78,0,-78
23803,0,0,31,0,-31
23804,0,0,12,0,-12
23805,0,0,16,0,-16
23806,1,0,26,0,-26
23807,1,1,796,1218,422
23808,0,0,37,0,-37
23809,1,0,2,0,-2
23810,1,1,363,1568,1205
23811,1,1,851,1227,376
23812,0,0,31,0,-31
23813,1,1,118,1780,1662
23814,1,1,395,1852,1457
23815,1,1,1087,1255,168
23816,0,0,26,0,-26
23817,1,0,8,0,-8
23818,0,0,49,0,-49
23819,1,1,1069,1724,655
23820,1,1,1255,1238,-17
23821,0,0,91,0,-91
23822,1,1,722,1300,578
23823,0,0,45,0,-45
23824,0,0,8,0,-8
23825,1,1,392,1318,926
23826,1,1,55,1947,1892
23827,1,0,6,0,-6
23828,0,0,34,0,-34
23829,0,0,8,0,-8
23830,0,0,37,0,-37
23831,0,0,9,0,-9
23832,0,0,146,0,-146
23833,1,0,10,0,-10
23834,1,1,231,1418,1187
23835,0,0,66,0,-66
23836,0,0,28,0,-28
23837,0,0,100,0,-100
23838,1,1,2707,1225,-1482
23839,1,1,99,1660,1561
23840,0,0,96,0,-96
23841,0,0,16,0,-16
23842,1,0,18,0,-18
23843,0,0,9,0,-9
23844,1,0,89,0,-89
23845,1,0,51,0,-51
23846,1,0,2,0,-2
23847,0,0,10,0,-10
23848,1,0,35,0,-35
23849,0,0,85,0,-85
23850,1,1,136,1271,1135
23851,1,1,150,1274,1124
23852,1,1,1277,1234,-43
23853,0,0,141,0,-141
23854,1,1,1206,1360,154
23855,0,0,82,0,-82
23856,1,1,164,1216,1052
23857,1,0,1,0,-1
23858,0,0,91,0,-91
23859,1,1,662,1731,1069
23860,1,0,150,0,-150
23861,1,1,1107,2103,996
23862,1,0,21,0,-21
23863,1,1,300,1353,1053
23864,1,1,676,1478,802
23865,1,0,21,0,-21
23866,1,1,77,1509,1432
23867,1,0,17,0,-17
23868,1,1,768,1294,526
23869,0,0,92,0,-92
23870,0,0,56,0,-56
23871,1,0,15,0,-15
23872,1,0,14,0,-14
23873,1,1,458,1315,857
23874,0,0,188,0,-188
23875,0,0,12,0,-12
23876,1,0,12,0,-12
23877,0,0,9,0,-9
23878,1,0,21,0,-21
23879,1,1,1253,1866,613
23880,0,0,53,0,-53
23881,0,0,23,0,-23
23882,1,0,105,0,-105
23883,1,0,58,0,-58
23884,0,0,17,0,-17
23885,1,0,93,0,-93
23886,1,1,294,1979,1685
23887,1,0,47,0,-47
23888,0,0,3,0,-3
23889,1,0,27,0,-27
23890,1,1,283,1428,1145
23891,1,1,1826,1212,-614
23892,0,0,64,0,-64
23893,0,0,5,0,-5
23894,1,1,262,1220,958
23895,0,0,89,0,-89
23896,1,0,30,0,-30
23897,1,0,21,0,-21
23898,0,0,9,0,-9
23899,1,0,42,0,-42
23900,1,1,396,1297,901
23901,1,0,191,0,-191
23902,0,0,45,0,-45
23903,1,1,650,2037,1387
23904,0,0,66,0,-66
23905,0,0,21,0,-21
23906,1,0,15,0,-15
23907,1,0,61,0,-61
23908,1,1,384,1269,885
23909,1,0,162,0,-162
23910,1,1,412,1733,1321
23911,0,0,24,0,-24
23912,0,0,4,0,-4
23913,0,0,19,0,-19
23914,0,0,68,0,-68
23915,0,0,117,0,-117
23916,0,0,64,0,-64
23917,1,0,26,0,-26
23918,1,0,13,0,-13
23919,0,0,56,0,-56
23920,0,0,0,0,0
23921,0,0,15,0,-15
23922,1,0,44,0,-44
23923,0,0,296,0,-296
23924,0,0,111,0,-111
23925,1,0,61,0,-61
23926,1,0,19,0,-19
23927,1,0,27,0,-27
23928,0,0,29,0,-29
23929,1,0,8,0,-8
23930,1,1,466,1413,947
23931,1,1,747,1961,1214
23932,1,1,589,1386,797
23933,1,0,81,0,-81
23934,0,0,2,0,-2
23935,1,0,31,0,-31
23936,1,1,210,1650,1440
23937,0,0,64,0,-64
23938,0,0,16,0,-16
23939,1,1,551,2325,1774
23940,1,0,74,0,-74
23941,1,1,609,1224,615
23942,1,1,954,1392,438
23943,1,1,565,1440,875
23944,1,1,644,1339,695
23945,1,1,801,1235,434
23946,0,0,26,0,-26
23947,0,0,19,0,-19
23948,0,0,72,0,-72
23949,0,0,39,0,-39
23950,0,0,7,0,-7
23951,1,0,105,0,-105
23952,1,1,553,1573,1020
23953,1,1,644,1205,561
23954,1,1,67,1205,1138
23955,0,0,31,0,-31
23956,0,0,19,0,-19
23957,0,0,84,0,-84
23958,1,0,12,0,-12
23959,0,0,34,0,-34
23960,1,0,117,0,-117
23961,1,1,617,1253,636
23962,1,1,1294,1212,-82
23963,1,0,35,0,-35
23964,0,0,9,0,-9
23965,0,0,99,0,-99
23966,0,0,9,0,-9
23967,1,1,90,2464,2374
23968,0,0,16,0,-16
23969,1,0,56,0,-56
23970,1,1,571,2655,2084
23971,1,0,6,0,-6
23972,0,0,2,0,-2
23973,1,1,63,1525,1462
23974,1,0,9,0,-9
23975,0,0,232,0,-232
23976,0,0,14,0,-14
23977,0,0,60,0,-60
23978,1,1,2491,1921,-570
23979,1,1,1014,1357,343
23980,0,0,60,0,-60
23981,1,0,71,0,-71
23982,0,0,27,0,-27
23983,0,0,14,0,-14
23984,0,0,10,0,-10
23985,1,1,3,1569,1566
23986,0,0,8,0,-8
23987,0,0,120,0,-120
23988,1,1,168,1259,1091
23989,1,1,382,1210,828
23990,0,0,17,0,-17
23991,1,1,164,2434,2270
23992,0,0,54,0,-54
23993,0,0,20,0,-20
23994,1,1,379,1613,1234
23995,0,0,54,0,-54
23996,0,0,59,0,-59
23997,1,0,66,0,-66
23998,0,0,37,0,-37
23999,0,0,7,0,-7
24000,1,1,124,1232,1108
24001,0,0,35,0,-35
24002,0,0,388,0,-388
24003,0,0,66,0,-66
24004,1,1,564,1694,1130
24005,1,1,86,1765,1679
24006,0,0,149,0,-149
24007,0,0,134,0,-134
24008,1,0,111,0,-111
24009,0,0,12,0,-12
24010,1,0,78,0,-78
24011,1,1,215,1218,1003
24012,0,0,50,0,-50
24013,0,0,41,0,-41
24014,1,1,824,1954,1130
24015,1,0,61,0,-61
24016,1,1,180,1752,1572
24017,1,1,1143,1205,62
24018,0,0,50,0,-50
24019,0,0,75,0,-75
24020,1,0,0,0,0
24021,1,1,403,1638,1235
24022,1,1,170,1843,1673
24023,1,1,19,1400,1381
24024,1,1,359,2224,1865
24025,1,0,1,0,-1
24026,1,0,13,0,-13
24027,1,1,177,1227,1050
24028,1,0,45,0,-45
24029,1,1,330,1400,1070
24030,0,0,1,0,-1
24031,1,1,1387,1403,16
24032,1,1,157,1240,1083
24033,1,0,145,0,-145
24034,1,0,17,0,-17
24035,0,0,4,0,-4
24036,0,0,56,0,-56
24037,1,0,13,0,-13
24038,1,0,93,0,-93
24039,1,1,293,1504,1211
24040,0,0,91,0,-91
24041,0,0,8,0,-8
24042,0,0,82,0,-82
24043,0,0,30,0,-30
24044,0,0,13,0,-13
24045,1,0,16,0,-16
24046,1,1,436,1234,798
24047,1,0,156,0,-156
24048,0,0,17,0,-17
24049,0,0,19,0,-19
24050,0,0,237,0,-237
24051,0,0,43,0,-43
24052,0,0,36,0,-36
24053,1,0,11,0,-11
24054,1,0,6,0,-6
24055,1,1,117,1228,1111
24056,1,1,1248,1609,361
24057,0,0,226,0,-226
24058,0,0,99,0,-99
24059,1,1,1141,2833,1692
24060,1,1,1153,1209,56
24061,0,0,108,0,-108
24062,1,0,93,0,-93
24063,0,0,64,0,-64
24064,1,0,41,0,-41
24065,1,1,45,1907,1862
24066,1,1,671,1203,532
24067,0,0,25,0,-25
24068,0,0,225,0,-225
24069,0,0,19,0,-19
24070,1,0,25,0,-25
24071,0,0,32,0,-32
24072,1,0,1,0,-1
24073,1,1,272,1473,1201
24074,1,0,56,0,-56
24075,1,1,92,2121,2029
24076,1,1,149,1305,1156
24077,1,0,2,0,-2
24078,1,0,3,0,-3
24079,1,1,353,1236,883
24080,0,0,142,0,-142
24081,1,1,1031,1905,874
24082,1,0,51,0,-51
24083,1,0,39,0,-39
24084,0,0,42,0,-42
24085,1,0,18,0,-18
24086,0,0,36,0,-36
24087,0,0,180,0,-180
24088,1,0,11,0,-11
24089,0,0,0,0,0
24090,1,1,836,1260,424
24091,1,1,339,1413,1074
24092,1,0,75,0,-75
24093,0,0,246,0,-246
24094,0,0,95,0,-95
24095,0,0,5,0,-5
24096,1,1,54,2424,2370
24097,1,1,21,1248,1227
24098,1,1,209,1264,1055
24099,1,1,196,1389,1193
24100,1,0,8,0,-8
24101,1,0,372,0,-372
24102,1,1,336,1950,1614
24103,0,0,40,0,-40
24104,1,0,1,0,-1
24105,1,0,36,0,-36
24106,0,0,11,0,-11
24107,1,0,70,0,-70
24108,1,0,176,0,-176
24109,1,1,31,1245,1214
24110,0,0,10,0,-10
24111,0,0,140,0,-140
24112,0,0,92,0,-92
24113,1,0,33,0,-33
24114,0,0,42,0,-42
24115,1,0,13,0,-13
24116,1,1,108,1894,1786
24117,0,0,0,0,0
24118,0,0,155,0,-155
24119,1,0,80,0,-80
24120,1,0,35,0,-35
24121,1,1,829,1223,394
24122,0,0,14,0,-14
24123,0,0,48,0,-48
24124,0,0,58,0,-58
24125,0,0,12,0,-12
24126,0,0,18,0,-18
24127,0,0,7,0,-7
24128,1,1,520,1206,686
24129,1,0,25,0,-25
24130,0,0,47,0,-47
24131,0,0,49,0,-49
24132,1,0,27,0,-27
24133,1,1,98,1270,1172
24134,0,0,76,0,-76
24135,0,0,55,0,-55
24136,1,0,61,0,-61
24137,0,0,15,0,-15
24138,1,0,125,0,-125
24139,1,1,270,1543,1273
24140,1,1,1279,1222,-57
24141,1,1,374,1202,828
24142,0,0,88,0,-88
24143,1,0,102,0,-102
24144,1,0,90,0,-90
24145,0,0,44,0,-44
24146,0,0,40,0,-40
24147,1,1,260,1344,1084
24148,0,0,56,0,-56
24149,1,0,24,0,-24
24150,1,1,647,1310,663
24151,1,0,45,0,-45
24152,1,0,38,0,-38
24153,1,0,5,0,-5
24154,1,1,653,1389,736
24155,0,0,60,0,-60
24156,0,0,66,0,-66
24157,0,0,51,0,-51
24158,1,1,55,1258,1203
24159,1,0,149,0,-149
24160,1,1,43,1593,1550
24161,1,0,7,0,-7
24162,0,0,39,0,-39
24163,0,0,43,0,-43
24164,0,0,8,0,-8
24165,1,1,980,2424,1444
24166,1,1,1125,1351,226
24167,1,0,13,0,-13
24168,1,1,1110,1261,151
24169,0,0,99,0,-99
24170,1,0,63,0,-63
24171,0,0,78,0,-78
24172,1,1,954,1479,525
24173,1,0,18,0,-18
24174,1,1,210,1719,1509
24175,1,1,711,1397,686
24176,1,1,172,1421,1249
24177,0,0,31,0,-31
24178,0,0,54,0,-54
24179,1,1,699,2055,1356
24180,1,0,77,0,-77
24181,0,0,2,0,-2
24182,1,1,722,1746,1024
24183,1,1,586,1484,898
24184,1,0,36,0,-36
24185,0,0,48,0,-48
24186,0,0,35,0,-35
24187,1,1,96,1346,1250
24188,0,0,82,0,-82
24189,0,0,15,0,-15
24190,0,0,40,0,-40
24191,0,0,12,0,-12
24192,1,1,193,1235,1042
24193,1,1,305,1227,922
24194,0,0,109,0,-109
24195,0,0,47,0,-47
24196,0,0,23,0,-23
24197,1,1,350,1631,1281
24198,1,1,2358,1222,-1136
24199,1,0,124,0,-124
24200,1,0,12,0,-12
24201,0,0,32,0,-32
24202,1,0,28,0,-28
24203,1,1,738,1746,1008
24204,1,0,58,0,-58
24205,0,0,230,0,-230
24206,1,0,29,0,-29
24207,0,0,90,0,-90
24208,0,0,37,0,-37
24209,1,1,661,1382,721
24210,1,1,247,1432,1185
24211,1,1,635,2683,2048
24212,0,0,24,0,-24
24213,1,0,37,0,-37
24214,1,0,1,0,-1
24215,1,0,43,0,-43
24216,0,0,36,0,-36
24217,0,0,9,0,-9
24218,0,0,31,0,-31
24219,1,0,75,0,-75
24220,1,0,29,0,-29
24221,0,0,15,0,-15
24222,0,0,104,0,-104
24223,0,0,8,0,-8
24224,0,0,20,0,-20
24225,1,0,92,0,-92
24226,0,0,4,0,-4
24227,1,1,330,1509,1179
24228,0,0,88,0,-88
24229,0,0,59,0,-59
24230,1,0,78,0,-78
24231,1,1,286,1813,1527
24232,1,1,1175,1253,78
24233,0,0,101,0,-101
24234,1,1,3761,2460,-1301
24235,1,1,712,1422,710
24236,1,0,131,0,-131
24237,0,0,26,0,-26
24238,1,0,9,0,-9
24239,0,0,22,0,-22
24240,0,0,91,0,-91
24241,1,1,150,1699,1549
24242,0,0,164,0,-164
24243,0,0,87,0,-87
24244,0,0,73,0,-73
24245,1,0,7,0,-7
24246,1,1,195,1515,1320
24247,0,0,97,0,-97
24248,1,0,8,0,-8
24249,0,0,30,0,-30
24250,0,0,35,0,-35
24251,1,1,684,4395,3711
24252,1,0,6,0,-6
24253,1,1,928,1443,515
24254,1,1,372,1551,1179
24255,0,0,2,0,-2
24256,0,0,27,0,-27
24257,1,1,108,1285,1177
24258,1,0,38,0,-38
24259,1,0,1,0,-1
24260,1,0,29,0,-29
24261,0,0,4,0,-4
24262,0,0,145,0,-145
24263,0,0,28,0,-28
24264,1,0,0,0,0
24265,1,0,92,0,-92
24266,0,0,0,0,0
24267,1,0,48,0,-48
24268,0,0,30,0,-30
24269,1,1,185,1356,1171
24270,0,0,52,0,-52
24271,0,0,3,0,-3
24272,0,0,26,0,-26
24273,0,0,5,0,-5
24274,1,0,41,0,-41
24275,1,0,54,0,-54
24276,1,0,180,0,-180
24277,0,0,21,0,-21
24278,1,0,29,0,-29
24279,1,0,9,0,-9
24280,0,0,2,0,-2
24281,1,1,2246,1647,-599
24282,1,1,539,1279,740
24283,1,0,18,0,-18
24284,1,1,142,2967,2825
24285,0,0,109,0,-109
24286,1,1,621,3259,2638
24287,0,0,15,0,-15
24288,1,0,10,0,-10
24289,1,1,131,1681,1550
24290,1,1,485,2688,2203
24291,1,1,216,3092,2876
24292,1,1,567,1249,682
24293,0,0,131,0,-131
24294,0,0,45,0,-45
24295,1,1,1317,1252,-65
24296,1,1,149,1808,1659
24297,1,0,59,0,-59
24298,1,0,63,0,-63
24299,0,0,31,0,-31
24300,1,1,2004,1340,-664
24301,1,0,4,0,-4
24302,1,0,36,0,-36
24303,0,0,3,0,-3
24304,1,0,41,0,-41
24305,1,0,90,0,-90
24306,1,0,209,0,-209
24307,0,0,43,0,-43
24308,1,0,42,0,-42
24309,0,0,20,0,-20
24310,0,0,79,0,-79
24311,1,0,28,0,-28
24312,1,0,3,0,-3
24313,1,0,149,0,-149
24314,1,0,19,0,-19
24315,1,0,4,0,-4
24316,0,0,62,0,-62
24317,0,0,14,0,-14
24318,1,0,36,0,-36
24319,0,0,8,0,-8
24320,1,0,35,0,-35
24321,0,0,75,0,-75
24322,1,0,24,0,-24
24323,1,1,804,1676,872
24324,0,0,24,0,-24
24325,0,0,124,0,-124
24326,1,0,43,0,-43
24327,0,0,43,0,-43
24328,1,1,584,1555,971
24329,0,0,132,0,-132
24330,1,0,12,0,-12
24331,0,0,31,0,-31
24332,0,0,24,0,-24
24333,0,0,13,0,-13
24334,0,0,10,0,-10
24335,1,0,20,0,-20
24336,1,1,514,1452,938
24337,0,0,87,0,-87
24338,1,1,657,1235,578
24339,0,0,122,0,-122
24340,0,0,85,0,-85
24341,0,0,64,0,-64
24342,1,0,68,0,-68
24343,1,0,33,0,-33
24344,1,0,73,0,-73
24345,1,1,314,2137,1823
24346,0,0,30,0,-30
24347,1,1,346,1248,902
24348,0,0,222,0,-222
24349,0,0,72,0,-72
24350,1,1,877,1245,368
24351,1,0,73,0,-73
24352,0,0,0,0,0
24353,0,0,11,0,-11
24354,1,1,244,1397,1153
24355,1,1,386,1660,1274
24356,1,0,18,0,-18
24357,1,0,23,0,-23
24358,1,1,314,1225,911
24359,0,0,24,0,-24
24360,0,0,51,0,-51
24361,1,0,11,0,-11
24362,1,1,404,1700,1296
24363,0,0,50,0,-50
24364,1,1,92,1652,1560
24365,0,0,43,0,-43
24366,1,1,1162,1950,788
24367,1,0,84,0,-84
24368,1,0,23,0,-23
24369,1,1,76,1206,1130
24370,1,1,1028,1218,190
24371,0,0,3,0,-3
24372,1,0,41,0,-41
24373,0,0,38,0,-38
24374,0,0,19,0,-19
24375,0,0,8,0,-8
24376,1,0,55,0,-55
24377,1,1,138,1814,1676
24378,1,0,24,0,-24
24379,1,0,121,0,-121
24380,1,0,247,0,-247
24381,1,0,1,0,-1
24382,1,1,525,2426,1901
24383,1,1,206,1363,1157
24384,0,0,64,0,-64
24385,1,0,9,0,-9
24386,0,0,62,0,-62
24387,1,0,60,0,-60
24388,0,0,23,0,-23
24389,1,1,739,1243,504
24390,0,0,114,0,-114
24391,1,1,517,1370,853
24392,1,1,1171,1441,270
24393,1,0,64,0,-64
24394,0,0,8,0,-8
24395,0,0,41,0,-41
24396,1,0,14,0,-14
24397,0,0,18,0,-18
24398,1,0,88,0,-88
24399,1,1,298,1236,938
24400,0,0,55,0,-55
24401,1,1,266,1993,1727
24402,1,1,315,1538,1223
24403,1,1,206,1294,1088
24404,1,1,414,1225,811
24405,0,0,15,0,-15
24406,1,1,70,1910,1840
24407,0,0,63,0,-63
24408,1,1,269,1516,1247
24409,0,0,1,0,-1
24410,1,0,24,0,-24
24411,1,0,87,0,-87
24412,0,0,31,0,-31
24413,1,1,6,1323,1317
24414,1,0,23,0,-23
24415,1,1,369,1236,867
24416,1,1,229,1771,1542
24417,1,0,64,0,-64
24418,1,0,61,0,-61
24419,1,0,16,0,-16
24420,1,0,3,0,-3
24421,0,0,32,0,-32
24422,0,0,20,0,-20
24423,0,0,156,0,-156
24424,1,1,952,1462,510
24425,0,0,87,0,-87
24426,1,1,19,1225,1206
24427,1,1,2305,1298,-1007
24428,1,0,54,0,-54
24429,1,1,259,1346,1087
24430,0,0,21,0,-21
24431,1,0,34,0,-34
24432,1,0,47,0,-47
24433,1,1,114,1401,1287
24434,1,0,142,0,-142
24435,1,1,1321,1939,618
24436,0,0,34,0,-34
24437,1,0,226,0,-226
24438,0,0,39,0,-39
24439,1,0,86,0,-86
24440,1,0,23,0,-23
24441,0,0,66,0,-66
24442,1,0,6,0,-6
24443,1,1,972,1444,472
24444,1,1,1320,2635,1315
24445,0,0,39,0,-39
24446,0,0,174,0,-174
24447,0,0,66,0,-66
24448,1,1,1040,1467,427
24449,0,0,80,0,-80
24450,0,0,74,0,-74
24451,0,0,55,0,-55
24452,1,0,19,0,-19
24453,1,1,118,1571,1453
24454,1,1,29,1259,1230
24455,1,1,257,2134,1877
24456,1,1,38,2536,2498
24457,0,0,6,0,-6
24458,1,0,17,0,-17
24459,1,0,49,0,-49
24460,0,0,97,0,-97
24461,0,0,90,0,-90
24462,1,1,735,2933,2198
24463,1,0,7,0,-7
24464,0,0,90,0,-90
24465,0,0,53,0,-53
24466,1,1,199,1271,1072
24467,1,0,274,0,-274
24468,0,0,48,0,-48
24469,0,0,90,0,-90
24470,0,0,39,0,-39
24471,0,0,7,0,-7
24472,0,0,13,0,-13
24473,0,0,52,0,-52
24474,1,0,10,0,-10
24475,1,0,62,0,-62
24476,1,0,3,0,-3
24477,0,0,55,0,-55
24478,1,1,402,1214,812
24479,1,0,22,0,-22
24480,1,1,1280,1202,-78
24481,1,0,18,0,-18
24482,0,0,42,0,-42
24483,1,1,99,1281,1182
24484,1,1,2055,1298,-757
24485,0,0,25,0,-25
24486,1,0,76,0,-76
24487,0,0,9,0,-9
24488,1,0,36,0,-36
24489,0,0,25,0,-25
24490,0,0,71,0,-71
24491,0,0,38,0,-38
24492,1,0,4,0,-4
24493,0,0,19,0,-19
24494,1,1,1105,2011,906
24495,1,0,14,0,-14
24496,1,1,774,1251,477
24497,1,1,232,1582,1350
24498,1,1,858,1457,599
24499,0,0,94,0,-94
24500,1,0,28,0,-28
24501,1,0,66,0,-66
24502,1,0,1,0,-1
24503,1,1,171,1813,1642
24504,0,0,113,0,-113
24505,0,0,35,0,-35
24506,1,0,2,0,-2
24507,1,0,26,0,-26
24508,1,0,149,0,-149
24509,1,0,40,0,-40
24510,0,0,12,0,-12
24511,0,0,66,0,-66
24512,1,0,6,0,-6
24513,1,0,30,0,-30
24514,0,0,91,0,-91
24515,1,0,61,0,-61
24516,1,0,14,0,-14
24517,1,1,673,1379,706
24518,1,0,8,0,-8
24519,0,0,39,0,-39
24520,1,0,3,0,-3
24521,1,1,749,1434,685
24522,0,0,10,0,-10
24523,1,0,5,0,-5
24524,1,1,243,1221,978
24525,0,0,26,0,-26
24526,0,0,34,0,-34
24527,0,0,13,0,-13
24528,0,0,95,0,-95
24529,0,0,34,0,-34
24530,0,0,1,0,-1
24531,1,1,623,1455,832
24532,1,0,8,0,-8
24533,0,0,55,0,-55
24534,0,0,16,0,-16
24535,0,0,51,0,-51
24536,1,1,227,1223,996
24537,0,0,116,0,-116
24538,0,0,35,0,-35
24539,1,1,573,1524,951
24540,1,1,378,1556,1178
24541,1,1,1108,1439,331
24542,0,0,16,0,-16
24543,1,1,245,1240,995
24544,0,0,34,0,-34
24545,0,0,68,0,-68
24546,0,0,13,0,-13
24547,0,0,32,0,-32
24548,0,0,76,0,-76
24549,1,0,43,0,-43
24550,1,0,2,0,-2
24551,0,0,10,0,-10
24552,1,0,107,0,-107
24553,1,1,388,2935,2547
24554,1,1,1240,1217,-23
24555,1,1,655,2673,2018
24556,1,0,27,0,-27
24557,1,1,219,1557,1338
24558,1,0,155,0,-155
24559,0,0,70,0,-70
24560,1,0,30,0,-30
24561,1,0,2,0,-2
24562,0,0,70,0,-70
24563,1,1,166,1220,1054
24564,1,0,56,0,-56
24565,1,0,53,0,-53
24566,1,1,1758,1281,-477
24567,1,1,233,1750,1517
24568,1,0,1,0,-1
24569,1,0,1,0,-1
24570,0,0,60,0,-60
24571,1,0,30,0,-30
24572,1,1,448,1719,1271
24573,0,0,24,0,-24
24574,1,1,163,1261,1098
24575,0,0,10,0,-10
24576,1,1,596,1364,768
24577,0,0,53,0,-53
24578,1,1,311,1380,1069
24579,0,0,38,0,-38
24580,0,0,2,0,-2
24581,1,0,117,0,-117
24582,1,1,61,2508,2447
24583,1,1,140,1210,1070
24584,1,0,100,0,-100
24585,1,1,341,1346,1005
24586,1,1,653,1644,991
24587,1,1,1223,1387,164
24588,1,1,680,1203,523
24589,1,0,169,0,-169
24590,0,0,4,0,-4
24591,0,0,11,0,-11
24592,0,0,7,0,-7
24593,1,0,93,0,-93
24594,1,1,42,1643,1601
24595,1,1,148,1371,1223
24596,1,0,38,0,-38
24597,1,1,297,1253,956
24598,0,0,22,0,-22
24599,0,0,238,0,-238
24600,1,1,406,1559,1153
24601,0,0,268,0,-268
24602,1,1,1040,1204,164
24603,0,0,99,0,-99
24604,0,0,17,0,-17
24605,1,1,498,1348,850
24606,1,1,42,2785,2743
24607,1,1,120,1473,1353
24608,0,0,30,0,-30
24609,1,1,534,1275,741
24610,0,0,9,0,-9
24611,1,1,1015,1364,349
24612,1,1,1192,1364,172
24613,0,0,9,0,-9
24614,1,1,947,1507,560
24615,0,0,14,0,-14
24616,0,0,7,0,-7
24617,1,0,85,0,-85
24618,0,0,212,0,-212
24619,1,0,67,0,-67
24620,0,0,0,0,0
24621,0,0,13,0,-13
24622,1,1,232,2410,2178
24623,1,0,26,0,-26
24624,0,0,207,0,-207
24625,1,0,1,0,-1
24626,0,0,130,0,-130
24627,0,0,30,0,-30
24628,0,0,21,0,-21
24629,0,0,0,0,0
24630,1,1,380,1561,1181
24631,1,0,17,0,-17
24632,0,0,13,0,-13
24633,0,0,6,0,-6
24634,1,0,8,0,-8
24635,0,0,18,0,-18
24636,1,0,13,0,-13
24637,0,0,149,0,-149
24638,0,0,7,0,-7
24639,0,0,14,0,-14
24640,1,0,3,0,-3
24641,0,0,51,0,-51
24642,1,0,9,0,-9
24643,1,0,19,0,-19
24644,0,0,198,0,-198
24645,0,0,71,0,-71
24646,0,0,61,0,-61
24647,0,0,40,0,-40
24648,0,0,62,0,-62
24649,1,0,100,0,-100
24650,0,0,12,0,-12
24651,1,0,101,0,-101
24652,1,0,56,0,-56
24653,1,0,77,0,-77
24654,0,0,10,0,-10
24655,1,1,1899,1247,-652
24656,1,1,417,1277,860
24657,1,0,70,0,-70
24658,1,0,73,0,-73
24659,1,0,137,0,-137
24660,1,0,76,0,-76
24661,0,0,5,0,-5
24662,1,1,451,1565,1114
24663,1,1,243,1544,1301
24664,1,0,81,0,-81
24665,0,0,15,0,-15
24666,0,0,67,0,-67
24667,1,0,29,0,-29
24668,1,1,254,1510,1256
24669,0,0,59,0,-59
24670,1,0,43,0,-43
24671,0,0,31,0,-31
24672,1,0,7,0,-7
24673,1,0,32,0,-32
24674,1,0,7,0,-7
24675,1,1,844,1279,435
24676,0,0,52,0,-52
24677,1,0,85,0,-85
24678,1,0,51,0,-51
24679,1,1,794,1207,413
24680,1,0,54,0,-54
24681,1,1,417,1220,803
24682,1,1,449,1725,1276
24683,0,0,13,0,-13
24684,1,1,78,1223,1145
24685,1,1,849,1425,576
24686,1,0,14,0,-14
24687,1,0,97,0,-97
24688,1,0,95,0,-95
24689,0,0,4,0,-4
24690,0,0,123,0,-123
24691,1,0,19,0,-19
24692,1,0,158,0,-158
24693,1,0,35,0,-35
24694,1,1,124,5374,5250
24695,0,0,65,0,-65
24696,0,0,12,0,-12
24697,0,0,10,0,-10
24698,1,0,110,0,-110
24699,1,1,530,1637,1107
24700,1,1,116,1269,1153
24701,1,1,631,1721,1090
24702,0,0,187,0,-187
24703,1,0,60,0,-60
24704,1,1,64,1337,1273
24705,1,1,322,1365,1043
24706,0,0,15,0,-15
24707,1,0,35,0,-35
24708,0,0,25,0,-25
24709,0,0,51,0,-51
24710,0,0,1,0,-1
24711,1,0,114,0,-114
24712,1,0,18,0,-18
24713,0,0,135,0,-135
24714,1,1,1344,1505,161
24715,0,0,190,0,-190
24716,1,0,0,0,0
24717,0,0,3,0,-3
24718,1,1,1474,1205,-269
24719,1,1,108,1421,1313
24720,0,0,5,0,-5
24721,0,0,95,0,-95
24722,1,1,1474,1203,-271
24723,0,0,91,0,-91
24724,0,0,24,0,-24
24725,0,0,46,0,-46
24726,0,0,16,0,-16
24727,1,1,269,1221,952
24728,0,0,46,0,-46
24729,1,1,527,1421,894
24730,1,0,62,0,-62
24731,0,0,26,0,-26
24732,1,0,20,0,-20
24733,0,0,67,0,-67
24734,0,0,114,0,-114
24735,0,0,8,0,-8
24736,1,1,768,1324,556
24737,0,0,49,0,-49
24738,1,1,47,1240,1193
24739,0,0,234,0,-234
24740,1,0,24,0,-24
24741,1,0,106,0,-106
24742,0,0,120,0,-120
24743,0,0,0,0,0
24744,1,1,136,1892,1756
24745,0,0,23,0,-23
24746,1,1,191,1458,1267
24747,1,0,28,0,-28
24748,1,0,67,0,-67
24749,0,0,24,0,-24
24750,0,0,6,0,-6
24751,1,1,294,1304,1010
24752,0,0,0,0,0
24753,1,0,37,0,-37
24754,0,0,8,0,-8
24755,0,0,105,0,-105
24756,1,1,388,1267,879
24757,1,1,236,1230,994
24758,1,0,32,0,-32
24759,1,0,89,0,-89
24760,1,1,197,1204,1007
24761,0,0,19,0,-19
24762,1,1,500,1453,953
24763,0,0,43,0,-43
24764,0,0,5,0,-5
24765,0,0,49,0,-49
24766,1,0,54,0,-54
24767,0,0,244,0,-244
24768,0,0,4,0,-4
24769,0,0,14,0,-14
24770,1,1,46,1821,1775
24771,1,1,2589,2494,-95
24772,1,0,8,0,-8
24773,1,0,76,0,-76
24774,1,1,383,3912,3529
24775,0,0,11,0,-11
24776,1,1,251,1233,982
24777,0,0,13,0,-13
24778,1,1,142,1444,1302
24779,1,1,301,1461,1160
24780,1,1,997,1534,537
24781,0,0,117,0,-117
24782,1,0,6,0,-6
24783,1,0,53,0,-53
24784,0,0,32,0,-32
24785,0,0,51,0,-51
24786,0,0,15,0,-15
24787,1,1,215,1377,1162
24788,1,1,112,1533,1421
24789,1,0,101,0,-101
24790,1,1,237,1403,1166
24791,1,1,523,1771,1248
24792,0,0,0,0,0
24793,1,0,41,0,-41
24794,1,0,158,0,-158
24795,1,0,34,0,-34
24796,1,0,30,0,-30
24797,1,0,34,0,-34
24798,1,0,47,0,-47
24799,1,1,365,1412,1047
24800,1,1,225,1460,1235
24801,1,0,66,0,-66
24802,0,0,52,0,-52
24803,1,0,2,0,-2
24804,1,0,15,0,-15
24805,1,1,68,1556,1488
24806,1,1,1228,1258,30
24807,1,1,186,1626,1440
24808,0,0,127,0,-127
24809,1,1,96,1412,1316
24810,1,0,60,0,-60
24811,0,0,23,0,-23
24812,1,1,1149,1461,312
24813,1,0,10,0,-10
24814,0,0,32,0,-32
24815,1,0,10,0,-10
24816,1,1,1800,1548,-252
24817,1,1,228,1259,1031
24818,0,0,128,0,-128
24819,0,0,16,0,-16
24820,1,0,10,0,-10
24821,0,0,56,0,-56
24822,0,0,82,0,-82
24823,0,0,11,0,-11
24824,1,0,227,0,-227
24825,1,1,489,1373,884
24826,0,0,20,0,-20
24827,1,1,843,1276,433
24828,0,0,100,0,-100
24829,1,1,92,1342,1250
24830,1,0,90,0,-90
24831,1,0,51,0,-51
24832,0,0,32,0,-32
24833,1,0,31,0,-31
24834,1,1,114,1272,1158
24835,0,0,16,0,-16
24836,1,1,171,1297,1126
24837,0,0,85,0,-85
24838,1,1,663,1513,850
24839,1,0,113,0,-113
24840,1,0,4,0,-4
24841,1,0,41,0,-41
24842,0,0,33,0,-33
24843,1,0,0,0,0
24844,1,1,528,1266,738
24845,0,0,41,0,-41
24846,1,0,26,0,-26
24847,1,1,988,1324,336
24848,0,0,70,0,-70
24849,0,0,37,0,-37
24850,0,0,187,0,-187
24851,1,1,246,2242,1996
24852,1,0,58,0,-58
24853,1,0,0,0,0
24854,1,0,11,0,-11
24855,1,0,78,0,-78
24856,1,1,1407,1477,70
24857,0,0,7,0,-7
24858,1,1,264,1224,960
24859,0,0,47,0,-47
24860,0,0,2,0,-2
24861,1,0,4,0,-4
24862,1,0,10,0,-10
24863,1,1,340,2214,1874
24864,1,1,514,1454,940
24865,0,0,49,0,-49
24866,0,0,19,0,-19
24867,0,0,9,0,-9
24868,1,0,215,0,-215
24869,1,1,994,1571,577
24870,1,0,31,0,-31
24871,1,1,1112,1267,155
24872,1,0,68,0,-68
24873,1,1,392,1452,1060
24874,1,0,44,0,-44
24875,1,1,273,1501,1228
24876,1,1,356,1322,966
24877,1,0,93,0,-93
24878,0,0,178,0,-178
24879,0,0,51,0,-51
24880,0,0,3,0,-3
24881,0,0,32,0,-32
24882,0,0,89,0,-89
24883,0,0,14,0,-14
24884,1,0,37,0,-37
24885,0,0,49,0,-49
24886,0,0,56,0,-56
24887,1,1,480,1588,1108
24888,0,0,18,0,-18
24889,1,1,87,1224,1137
24890,1,1,488,1364,876
24891,0,0,14,0,-14
24892,1,1,267,1500,1233
24893,0,0,12,0,-12
24894,1,1,326,1339,1013
24895,0,0,123,0,-123
24896,1,0,31,0,-31
24897,1,1,103,1681,1578
24898,0,0,32,0,-32
24899,1,1,1546,1509,-37
24900,0,0,39,0,-39
24901,0,0,51,0,-51
24902,1,0,13,0,-13
24903,0,0,10,0,-10
24904,0,0,15,0,-15
24905,1,1,461,1634,1173
24906,0,0,4,0,-4
24907,1,1,210,1244,1034
24908,1,1,1022,1248,226
24909,1,0,15,0,-15
24910,0,0,35,0,-35
24911,0,0,122,0,-122
24912,1,1,398,1309,911
24913,0,0,193,0,-193
24914,1,0,47,0,-47
24915,0,0,9,0,-9
24916,1,0,62,0,-62
24917,1,1,37,1314,1277
24918,1,0,27,0,-27
24919,1,1,1830,1269,-561
24920,1,0,15,0,-15
24921,0,0,65,0,-65
24922,1,1,1867,2549,682
24923,0,0,49,0,-49
24924,1,1,310,1922,1612
24925,1,0,15,0,-15
24926,0,0,27,0,-27
24927,1,1,345,1306,961
24928,1,1,979,1391,412
24929,1,1,452,3134,2682
24930,1,1,613,2206,1593
24931,1,1,242,1853,1611
24932,1,1,163,1271,1108
24933,0,0,14,0,-14
24934,1,0,33,0,-33
24935,1,0,19,0,-19
24936,1,1,1020,1501,481
24937,1,1,654,1427,773
24938,1,1,209,1386,1177
24939,0,0,13,0,-13
24940,0,0,1,0,-1
24941,0,0,168,0,-168
24942,1,0,63,0,-63
24943,0,0,27,0,-27
24944,1,0,36,0,-36
24945,1,1,137,1266,1129
24946,0,0,27,0,-27
24947,1,0,54,0,-54
24948,1,1,263,1545,1282
24949,0,0,74,0,-74
24950,1,1,392,2191,1799
24951,1,0,77,0,-77
24952,1,1,526,1483,957
24953,0,0,31,0,-31
24954,0,0,81,0,-81
24955,1,1,557,1479,922
24956,1,1,466,1729,1263
24957,1,1,39,2005,1966
24958,1,0,7,0,-7
24959,1,0,4,0,-4
24960,1,0,5,0,-5
24961,1,1,545,1296,751
24962,0,0,132,0,-132
24963,1,0,6,0,-6
24964,1,1,202,1641,1439
24965,1,0,137,0,-137
24966,1,1,959,1771,812
24967,1,1,379,1246,867
24968,1,1,688,1513,825
24969,0,0,21,0,-21
24970,0,0,88,0,-88
24971,1,1,251,1679,1428
24972,0,0,81,0,-81
24973,1,1,1314,1901,587
24974,1,0,31,0,-31
24975,0,0,52,0,-52
24976,0,0,44,0,-44
24977,1,0,49,0,-49
24978,1,1,184,1450,1266
24979,0,0,28,0,-28
24980,1,1,1038,1520,482
24981,1,1,1121,1219,98
24982,1,1,264,1466,1202
24983,0,0,38,0,-38
24984,0,0,7,0,-7
24985,0,0,34,0,-34
24986,1,1,768,1258,490
24987,0,0,160,0,-160
24988,1,1,1215,1628,413
24989,1,1,360,3094,2734
24990,0,0,69,0,-69
24991,1,0,46,0,-46
24992,1,1,367,1520,1153
24993,0,0,4,0,-4
24994,1,1,332,1273,941
24995,1,0,3,0,-3
24996,1,1,185,2160,1975
24997,0,0,20,0,-20
24998,1,1,95,1455,1360
24999,1,1,351,1302,951
25000,0,0,8,0,-8
25001,0,0,0,0,0
25002,0,0,144,0,-144
25003,1,0,79,0,-79
25004,1,0,152,0,-152
25005,1,1,86,2845,2759
25006,0,0,23,0,-23
25007,1,1,1176,1603,427
25008,0,0,25,0,-25
25009,1,1,345,4562,4217
25010,1,1,50,1444,1394
25011,0,0,40,0,-40
25012,0,0,13,0,-13
25013,1,0,32,0,-32
25014,1,0,11,0,-11
25015,1,0,15,0,-15
25016,1,0,40,0,-40
25017,1,1,250,1352,1102
25018,1,1,756,2206,1450
25019,0,0,52,0,-52
25020,1,1,144,1509,1365
25021,1,0,89,0,-89
25022,0,0,94,0,-94
25023,1,0,6,0,-6
25024,0,0,50,0,-50
25025,1,0,47,0,-47
25026,0,0,85,0,-85
25027,0,0,22,0,-22
25028,0,0,21,0,-21
25029,0,0,20,0,-20
25030,1,0,49,0,-49
25031,1,0,17,0,-17
25032,0,0,31,0,-31
25033,0,0,50,0,-50
25034,1,0,80,0,-80
25035,0,0,0,0,0
25036,0,0,27,0,-27
25037,1,0,5,0,-5
25038,1,1,418,2126,1708
25039,1,0,63,0,-63
25040,1,0,66,0,-66
25041,1,0,45,0,-45
25042,1,1,217,1347,1130
25043,0,0,11,0,-11
25044,1,0,9,0,-9
25045,0,0,6,0,-6
25046,0,0,29,0,-29
25047,1,0,11,0,-11
25048,0,0,42,0,-42
25049,1,0,113,0,-113
25050,1,0,17,0,-17
25051,1,1,1045,1250,205
25052,1,1,818,1285,467
25053,1,0,26,0,-26
25054,0,0,38,0,-38
25055,0,0,198,0,-198
25056,1,0,53,0,-53
25057,1,1,553,2213,1660
25058,1,0,6,0,-6
25059,1,1,218,2358,2140
25060,1,1,1072,2835,1763
25061,1,1,661,1283,622
25062,0,0,124,0,-124
25063,1,1,230,1219,989
25064,0,0,67,0,-67
25065,0,0,45,0,-45
25066,1,0,7,0,-7
25067,1,0,20,0,-20
25068,0,0,37,0,-37
25069,0,0,51,0,-51
25070,1,0,154,0,-154
25071,1,0,26,0,-26
25072,1,1,128,2182,2054
25073,1,1,114,1283,1169
25074,1,1,475,1426,951
25075,0,0,20,0,-20
25076,1,1,32,1632,1600
25077,1,0,158,0,-158
25078,1,0,16,0,-16
25079,0,0,144,0,-144
25080,0,0,12,0,-12
25081,0,0,133,0,-133
25082,0,0,7,0,-7
25083,1,0,143,0,-143
25084,1,1,696,1246,550
25085,1,1,517,1307,790
25086,1,1,424,1835,1411
25087,1,1,539,1226,687
25088,1,0,22,0,-22
25089,0,0,9,0,-9
25090,0,0,53,0,-53
25091,0,0,28,0,-28
25092,1,1,1374,1853,479
25093,0,0,66,0,-66
25094,1,0,29,0,-29
25095,0,0,6,0,-6
25096,1,0,25,0,-25
25097,1,1,683,1563,880
25098,0,0,6,0,-6
25099,0,0,142,0,-142
25100,0,0,36,0,-36
25101,1,0,301,0,-301
25102,0,0,36,0,-36
25103,0,0,19,0,-19
25104,1,1,209,1205,996
25105,0,0,5,0,-5
25106,1,0,11,0,-11
25107,0,0,29,0,-29
25108,0,0,40,0,-40
25109,0,0,178,0,-178
25110,1,1,156,1642,1486
25111,0,0,9,0,-9
25112,0,0,0,0,0
25113,0,0,27,0,-27
25114,1,1,1212,1280,68
25115,1,1,449,2020,1571
25116,1,1,1094,2606,1512
25117,0,0,73,0,-73
25118,0,0,1,0,-1
25119,1,0,6,0,-6
25120,0,0,124,0,-124
25121,1,1,264,1888,1624
25122,0,0,28,0,-28
25123,1,1,822,1353,531
25124,1,0,5,0,-5
25125,1,0,5,0,-5
25126,1,1,301,1648,1347
25127,0,0,29,0,-29
25128,1,1,1363,1282,-81
25129,0,0,17,0,-17
25130,0,0,54,0,-54
25131,0,0,23,0,-23
25132,1,0,23,0,-23
25133,1,1,219,1205,986
25134,1,0,16,0,-16
25135,0,0,31,0,-31
25136,1,0,53,0,-53
25137,1,0,165,0,-165
25138,1,1,1938,2614,676
25139,0,0,61,0,-61
25140,0,0,18,0,-18
25141,1,0,67,0,-67
25142,1,1,156,1292,1136
25143,1,0,71,0,-71
25144,1,1,390,1683,1293
25145,1,1,303,1541,1238
25146,1,0,56,0,-56
25147,0,0,26,0,-26
25148,0,0,79,0,-79
25149,1,0,47,0,-47
25150,0,0,37,0,-37
25151,1,0,32,0,-32
25152,1,1,260,1201,941
25153,0,0,179,0,-179
25154,0,0,77,0,-77
25155,0,0,4,0,-4
25156,0,0,52,0,-52
25157,0,0,1,0,-1
25158,1,0,44,0,-44
25159,0,0,56,0,-56
25160,1,1,1246,1235,-11
25161,1,0,68,0,-68
25162,0,0,13,0,-13
25163,0,0,47,0,-47
25164,0,0,34,0,-34
25165,1,1,922,1593,671
25166,0,0,8,0,-8
25167,1,0,94,0,-94
25168,1,0,13,0,-13
25169,1,1,133,1686,1553
25170,1,1,63,1205,1142
25171,1,0,254,0,-254
25172,1,0,29,0,-29
25173,1,1,230,8543,8313
25174,0,0,26,0,-26
25175,1,1,249,1458,1209
25176,1,1,642,1288,646
25177,1,0,68,0,-68
25178,1,1,176,2047,1871
25179,0,0,31,0,-31
25180,1,1,641,1228,587
25181,1,1,423,2136,1713
25182,1,1,53,1227,1174
25183,1,0,100,0,-100
25184,1,1,634,1247,613
25185,0,0,16,0,-16
25186,0,0,1,0,-1
25187,1,1,941,1205,264
25188,0,0,13,0,-13
25189,1,0,5,0,-5
25190,0,0,29,0,-29
25191,1,0,42,0,-42
25192,1,0,123,0,-123
25193,1,1,393,1532,1139
25194,1,0,62,0,-62
25195,1,0,15,0,-15
25196,1,1,159,1348,1189
25197,1,0,206,0,-206
25198,1,0,24,0,-24
25199,1,1,298,1345,1047
25200,1,0,2,0,-2
25201,1,1,423,1539,1116
25202,1,1,189,1809,1620
25203,1,0,90,0,-90
25204,1,1,1470,1461,-9
25205,1,1,797,1213,416
25206,0,0,31,0,-31
25207,0,0,51,0,-51
25208,0,0,353,0,-353
25209,1,1,226,2175,1949
25210,0,0,7,0,-7
25211,1,0,14,0,-14
25212,0,0,44,0,-44
25213,0,0,101,0,-101
25214,1,0,96,0,-96
25215,0,0,10,0,-10
25216,1,1,1025,1345,320
25217,0,0,18,0,-18
25218,1,0,6,0,-6
25219,0,0,25,0,-25
25220,0,0,40,0,-40
25221,0,0,145,0,-145
25222,1,0,48,0,-48
25223,0,0,31,0,-31
25224,0,0,2,0,-2
25225,1,1,252,1648,1396
25226,0,0,14,0,-14
25227,1,1,215,1527,1312
25228,1,0,21,0,-21
25229,1,0,72,0,-72
25230,1,0,14,0,-14
25231,0,0,39,0,-39
25232,1,0,54,0,-54
25233,1,1,53,1325,1272
25234,0,0,101,0,-101
25235,0,0,55,0,-55
25236,0,0,47,0,-47
25237,1,1,21,1551,1530
25238,1,0,18,0,-18
25239,0,0,61,0,-61
25240,1,1,923,2883,1960
25241,1,0,79,0,-79
25242,0,0,56,0,-56
25243,0,0,17,0,-17
25244,0,0,106,0,-106
25245,1,0,229,0,-229
25246,1,0,45,0,-45
25247,1,0,33,0,-33
25248,0,0,52,0,-52
25249,1,1,639,1244,605
25250,0,0,11,0,-11
25251,1,1,410,2075,1665
25252,0,0,148,0,-148
25253,0,0,18,0,-18
25254,0,0,45,0,-45
25255,1,1,341,1486,1145
25256,0,0,6,0,-6
25257,0,0,2,0,-2
25258,0,0,57,0,-57
25259,1,1,1964,1275,-689
25260,1,1,298,1234,936
25261,0,0,198,0,-198
25262,1,0,18,0,-18
25263,0,0,47,0,-47
25264,1,1,396,1619,1223
25265,1,1,325,2179,1854
25266,0,0,73,0,-73
25267,1,0,105,0,-105
25268,1,0,14,0,-14
25269,0,0,8,0,-8
25270,0,0,188,0,-188
25271,0,0,52,0,-52
25272,1,0,32,0,-32
25273,1,1,919,1281,362
25274,0,0,41,0,-41
25275,0,0,33,0,-33
25276,1,0,105,0,-105
25277,1,0,55,0,-55
25278,0,0,47,0,-47
25279,1,0,10,0,-10
25280,0,0,18,0,-18
25281,1,0,59,0,-59
25282,0,0,93,0,-93
25283,0,0,206,0,-206
25284,1,1,156,1590,1434
25285,1,1,684,1994,1310
25286,1,0,152,0,-152
25287,0,0,19,0,-19
25288,1,0,87,0,-87
25289,1,1,581,1640,1059
25290,1,0,7,0,-7
25291,0,0,29,0,-29
25292,0,0,22,0,-22
25293,0,0,26,0,-26
25294,0,0,9,0,-9
25295,0,0,31,0,-31
25296,1,0,76,0,-76
25297,0,0,7,0,-7
25298,0,0,8,0,-8
25299,0,0,83,0,-83
25300,1,0,26,0,-26
25301,1,0,40,0,-40
25302,1,1,152,1222,1070
25303,0,0,11,0,-11
25304,0,0,73,0,-73
25305,1,1,351,2805,2454
25306,1,1,1081,2882,1801
25307,1,0,30,0,-30
25308,1,0,4,0,-4
25309,1,1,306,1515,1209
25310,1,1,1577,1303,-274
25311,1,0,5,0,-5
25312,1,1,414,1215,801
25313,0,0,17,0,-17
25314,1,1,49,1962,1913
25315,0,0,8,0,-8
25316,1,0,33,0,-33
25317,0,0,2,0,-2
25318,1,1,2579,1479,-1100
25319,0,0,35,0,-35
25320,1,0,9,0,-9
25321,1,1,655,2069,1414
25322,0,0,152,0,-152
25323,1,0,34,0,-34
25324,1,0,68,0,-68
25325,1,0,250,0,-250
25326,0,0,4,0,-4
25327,0,0,13,0,-13
25328,1,1,215,2572,2357
25329,1,0,166,0,-166
25330,1,1,850,2448,1598
25331,1,0,15,0,-15
25332,1,1,253,1302,1049
25333,1,1,1090,1352,262
25334,1,1,535,1459,924
25335,0,0,65,0,-65
25336,1,1,1385,1271,-114
25337,0,0,77,0,-77
25338,0,0,90,0,-90
25339,0,0,36,0,-36
25340,1,1,398,1372,974
25341,1,0,78,0,-78
25342,0,0,85,0,-85
25343,1,0,195,0,-195
25344,0,0,87,0,-87
25345,1,1,39,1909,1870
25346,1,1,375,1740,1365
25347,0,0,34,0,-34
25348,0,0,127,0,-127
25349,1,1,1013,1394,381
25350,1,0,92,0,-92
25351,1,0,6,0,-6
25352,0,0,31,0,-31
25353,0,0,24,0,-24
25354,1,0,14,0,-14
25355,0,0,41,0,-41
25356,1,1,358,1216,858
25357,1,0,3,0,-3
25358,1,1,172,1465,1293
25359,0,0,74,0,-74
25360,1,1,173,1703,1530
25361,1,0,36,0,-36
25362,1,1,1158,1790,632
25363,0,0,55,0,-55
25364,1,0,66,0,-66
25365,1,0,108,0,-108
25366,1,0,13,0,-13
25367,1,1,172,1385,1213
25368,1,0,85,0,-85
25369,0,0,0,0,0
25370,1,1,683,1346,663
25371,0,0,53,0,-53
25372,1,0,74,0,-74
25373,0,0,23,0,-23
25374,1,1,177,1771,1594
25375,1,1,410,1247,837
25376,1,0,28,0,-28
25377,0,0,10,0,-10
25378,1,1,892,3237,2345
25379,1,0,54,0,-54
25380,1,1,431,3912,3481
25381,0,0,11,0,-11
25382,1,0,61,0,-61
25383,1,0,14,0,-14
25384,1,0,62,0,-62
25385,1,0,28,0,-28
25386,0,0,117,0,-117
25387,1,1,1834,1977,143
25388,0,0,29,0,-29
25389,1,1,1049,1773,724
25390,1,0,61,0,-61
25391,0,0,2,0,-2
25392,0,0,33,0,-33
25393,1,1,415,1372,957
25394,1,0,120,0,-120
25395,1,0,89,0,-89
25396,0,0,50,0,-50
25397,1,0,16,0,-16
25398,1,0,48,0,-48
25399,1,1,413,1239,826
25400,0,0,36,0,-36
25401,0,0,5,0,-5
25402,1,1,634,1208,574
25403,1,1,599,1395,796
25404,1,1,835,1264,429
25405,1,1,1587,1407,-180
25406,0,0,62,0,-62
25407,1,0,18,0,-18
25408,1,1,93,2038,1945
25409,1,0,21,0,-21
25410,1,0,19,0,-19
25411,1,1,219,1663,1444
25412,0,0,115,0,-115
25413,1,0,68,0,-68
25414,1,0,2,0,-2
25415,1,1,97,1585,1488
25416,1,0,52,0,-52
25417,0,0,50,0,-50
25418,1,1,156,1547,1391
25419,0,0,16,0,-16
25420,1,1,508,1429,921
25421,0,0,44,0,-44
25422,1,1,971,1413,442
25423,1,1,195,1401,1206
25424,1,1,268,1318,1050
25425,0,0,2,0,-2
25426,1,0,1,0,-1
25427,0,0,62,0,-62
25428,0,0,64,0,-64
25429,1,1,589,1210,621
25430,0,0,8,0,-8
25431,1,1,1643,1237,-406
25432,1,1,646,1852,1206
25433,1,0,0,0,0
25434,0,0,132,0,-132
25435,1,1,417,1628,1211
25436,1,0,84,0,-84
25437,0,0,34,0,-34
25438,0,0,63,0,-63
25439,1,0,6,0,-6
25440,1,0,11,0,-11
25441,0,0,33,0,-33
25442,1,1,448,1270,822
25443,1,0,78,0,-78
25444,1,0,4,0,-4
25445,0,0,104,0,-104
25446,1,1,879,1410,531
25447,1,1,2698,1645,-1053
25448,1,0,48,0,-48
25449,0,0,74,0,-74
25450,1,0,63,0,-63
25451,1,1,361,1356,995
25452,1,1,773,1401,628
25453,0,0,49,0,-49
25454,1,0,112,0,-112
25455,1,1,66,1333,1267
25456,1,0,1,0,-1
25457,0,0,13,0,-13
25458,1,1,65,1200,1135
25459,1,1,761,1509,748
25460,1,0,20,0,-20
25461,1,1,527,1646,1119
25462,1,0,51,0,-51
25463,1,0,9,0,-9
25464,0,0,96,0,-96
25465,1,0,114,0,-114
25466,1,0,1,0,-1
25467,1,0,14,0,-14
25468,1,1,207,1418,1211
25469,0,0,39,0,-39
25470,1,1,744,1648,904
25471,1,0,72,0,-72
25472,1,1,1288,1431,143
25473,0,0,68,0,-68
25474,1,0,18,0,-18
25475,0,0,13,0,-13
25476,1,1,320,1570,1250
25477,1,1,1460,1400,-60
25478,1,0,42,0,-42
25479,1,1,305,1500,1195
25480,1,0,56,0,-56
25481,1,0,16,0,-16
25482,1,1,386,1306,920
25483,1,0,34,0,-34
25484,0,0,15,0,-15
25485,1,0,22,0,-22
25486,1,1,659,1436,777
25487,1,0,2,0,-2
25488,1,1,326,1871,1545
25489,1,1,761,3259,2498
25490,0,0,37,0,-37
25491,1,1,428,1220,792
25492,1,1,471,2161,1690
25493,1,0,1,0,-1
25494,0,0,10,0,-10
25495,0,0,38,0,-38
25496,1,0,61,0,-61
25497,1,0,69,0,-69
25498,1,1,1473,1796,323
25499,0,0,3,0,-3
25500,0,0,22,0,-22
25501,1,0,10,0,-10
25502,0,0,150,0,-150
25503,1,1,584,1291,707
25504,0,0,99,0,-99
25505,0,0,60,0,-60
25506,1,0,54,0,-54
25507,1,1,33,1448,1415
25508,1,1,203,1806,1603
25509,1,1,850,1526,676
25510,0,0,1,0,-1
25511,1,1,413,1323,910
25512,1,0,15,0,-15
25513,1,1,133,1302,1169
25514,0,0,10,0,-10
25515,1,0,19,0,-19
25516,0,0,3,0,-3
25517,1,1,376,1857,1481
25518,0,0,56,0,-56
25519,1,1,57,1787,1730
25520,1,0,5,0,-5
25521,0,0,43,0,-43
25522,1,0,6,0,-6
25523,1,0,6,0,-6
25524,0,0,83,0,-83
25525,0,0,71,0,-71
25526,1,0,26,0,-26
25527,0,0,27,0,-27
25528,1,1,94,1252,1158
25529,1,0,2,0,-2
25530,1,0,12,0,-12
25531,1,0,50,0,-50
25532,0,0,28,0,-28
25533,1,0,42,0,-42
25534,0,0,66,0,-66
25535,1,1,758,1303,545
25536,1,1,210,1768,1558
25537,0,0,45,0,-45
25538,1,0,74,0,-74
25539,0,0,214,0,-214
25540,1,1,54,1284,1230
25541,1,0,182,0,-182
25542,1,0,79,0,-79
25543,1,0,91,0,-91
25544,1,1,447,1544,1097
25545,1,1,690,1944,1254
25546,1,1,676,3016,2340
25547,1,0,32,0,-32
25548,1,0,41,0,-41
25549,1,1,741,1236,495
25550,0,0,47,0,-47
25551,0,0,95,0,-95
25552,1,0,20,0,-20
25553,0,0,59,0,-59
25554,0,0,73,0,-73
25555,1,1,246,1202,956
25556,1,1,535,1381,846
25557,0,0,49,0,-49
25558,1,1,724,1219,495
25559,1,0,80,0,-80
25560,1,0,13,0,-13
25561,1,0,7,0,-7
25562,0,0,4,0,-4
25563,1,0,127,0,-127
25564,1,0,31,0,-31
25565,1,1,650,1337,687
25566,0,0,5,0,-5
25567,0,0,14,0,-14
25568,0,0,66,0,-66
25569,1,1,269,1729,1460
25570,1,0,41,0,-41
25571,1,1,1014,1271,257
25572,0,0,39,0,-39
25573,0,0,14,0,-14
25574,1,1,173,1369,1196
25575,1,1,200,1223,1023
25576,1,0,37,0,-37
25577,1,0,62,0,-62
25578,1,1,51,1236,1185
25579,1,1,236,1330,1094
25580,1,0,20,0,-20
25581,0,0,180,0,-180
25582,1,1,134,1202,1068
25583,1,0,46,0,-46
25584,1,1,925,1265,340
25585,1,1,142,2339,2197
25586,1,0,10,0,-10
25587,0,0,55,0,-55
25588,1,1,854,1915,1061
25589,1,0,44,0,-44
25590,0,0,47,0,-47
25591,0,0,35,0,-35
25592,0,0,31,0,-31
25593,0,0,72,0,-72
25594,1,1,103,1270,1167
25595,1,0,36,0,-36
25596,1,0,10,0,-10
25597,1,1,144,1425,1281
25598,1,0,3,0,-3
25599,0,0,76,0,-76
25600,1,0,7,0,-7
25601,1,1,1576,2589,1013
25602,0,0,51,0,-51
25603,1,0,0,0,0
25604,1,1,336,1750,1414
25605,1,1,563,1637,1074
25606,1,0,3,0,-3
25607,1,0,131,0,-131
25608,0,0,44,0,-44
25609,0,0,2,0,-2
25610,0,0,20,0,-20
25611,0,0,39,0,-39
25612,1,0,97,0,-97
25613,0,0,47,0,-47
25614,1,0,34,0,-34
25615,1,0,56,0,-56
25616,1,0,55,0,-55
25617,0,0,64,0,-64
25618,0,0,12,0,-12
25619,0,0,22,0,-22
25620,1,1,202,1289,1087
25621,1,1,213,1649,1436
25622,1,0,61,0,-61
25623,0,0,20,0,-20
25624,0,0,83,0,-83
25625,1,0,6,0,-6
25626,0,0,109,0,-109
25627,0,0,15,0,-15
25628,1,0,8,0,-8
25629,0,0,157,0,-157
25630,1,1,289,1317,1028
25631,0,0,94,0,-94
25632,1,0,59,0,-59
25633,1,1,657,1327,670
25634,0,0,55,0,-55
25635,1,0,19,0,-19
25636,0,0,66,0,-66
25637,0,0,96,0,-96
25638,0,0,51,0,-51
25639,1,0,8,0,-8
25640,1,1,1011,1507,496
25641,0,0,13,0,-13
25642,1,1,1072,1292,220
25643,0,0,47,0,-47
25644,1,0,1,0,-1
25645,1,0,4,0,-4
25646,1,1,355,3019,2664
25647,1,0,17,0,-17
25648,0,0,32,0,-32
25649,1,1,474,1322,848
25650,0,0,62,0,-62
25651,0,0,18,0,-18
25652,1,1,88,1200,1112
25653,0,0,77,0,-77
25654,1,0,289,0,-289
25655,0,0,110,0,-110
25656,1,1,402,1528,1126
25657,0,0,0,0,0
25658,1,0,4,0,-4
25659,0,0,85,0,-85
25660,0,0,27,0,-27
25661,0,0,72,0,-72
25662,0,0,75,0,-75
25663,1,0,31,0,-31
25664,0,0,69,0,-69
25665,1,1,676,1673,997
25666,0,0,25,0,-25
25667,0,0,96,0,-96
25668,0,0,18,0,-18
25669,0,0,5,0,-5
25670,1,1,287,1603,1316
25671,1,0,25,0,-25
25672,1,1,580,3148,2568
25673,1,0,46,0,-46
25674,1,1,1256,1230,-26
25675,1,1,79,1791,1712
25676,1,0,39,0,-39
25677,1,0,59,0,-59
25678,0,0,17,0,-17
25679,1,1,237,1393,1156
25680,0,0,106,0,-106
25681,1,0,24,0,-24
25682,1,1,904,1272,368
25683,1,1,1271,1318,47
25684,0,0,60,0,-60
25685,1,0,42,0,-42
25686,0,0,70,0,-70
25687,0,0,6,0,-6
25688,1,0,21,0,-21
25689,1,0,60,0,-60
25690,1,0,46,0,-46
25691,0,0,187,0,-187
25692,0,0,25,0,-25
25693,1,0,28,0,-28
25694,1,1,247,1280,1033
25695,1,1,138,1901,1763
25696,1,0,42,0,-42
25697,1,1,19,1400,1381
25698,0,0,14,0,-14
25699,0,0,49,0,-49
25700,1,1,312,1262,950
25701,0,0,29,0,-29
25702,1,1,885,1383,498
25703,1,0,103,0,-103
25704,1,1,438,1203,765
25705,0,0,20,0,-20
25706,0,0,71,0,-71
25707,1,0,40,0,-40
25708,1,1,385,7386,7001
25709,1,0,3,0,-3
25710,0,0,34,0,-34
25711,1,1,1401,1401,0
25712,1,1,289,1676,1387
25713,1,0,80,0,-80
25714,0,0,22,0,-22
25715,1,1,1026,1218,192
25716,1,1,174,1543,1369
25717,0,0,18,0,-18
25718,1,0,62,0,-62
25719,1,0,14,0,-14
25720,1,1,481,1218,737
25721,0,0,36,0,-36
25722,0,0,2,0,-2
25723,1,0,86,0,-86
25724,1,1,1114,1555,441
25725,0,0,0,0,0
25726,1,0,152,0,-152
25727,1,1,1041,1278,237
25728,1,0,88,0,-88
25729,1,0,29,0,-29
25730,1,0,38,0,-38
25731,1,0,98,0,-98
25732,0,0,125,0,-125
25733,0,0,8,0,-8
25734,1,1,783,1269,486
25735,1,0,63,0,-63
25736,1,1,275,1752,1477
25737,0,0,114,0,-114
25738,1,0,120,0,-120
25739,1,1,1046,2139,1093
25740,1,1,1285,1276,-9
25741,1,1,564,1253,689
25742,1,0,43,0,-43
25743,0,0,36,0,-36
25744,0,0,37,0,-37
25745,0,0,81,0,-81
25746,1,1,250,1639,1389
25747,0,0,52,0,-52
25748,1,1,279,1720,1441
25749,1,0,36,0,-36
25750,0,0,35,0,-35
25751,0,0,92,0,-92
25752,0,0,278,0,-278
25753,1,1,430,1565,1135
25754,1,0,190,0,-190
25755,0,0,23,0,-23
25756,1,1,101,1286,1185
25757,1,0,19,0,-19
25758,0,0,7,0,-7
25759,1,1,291,1634,1343
25760,0,0,21,0,-21
25761,0,0,18,0,-18
25762,1,0,45,0,-45
25763,1,0,18,0,-18
25764,1,1,965,2568,1603
25765,1,0,21,0,-21
25766,0,0,44,0,-44
25767,0,0,298,0,-298
25768,1,0,22,0,-22
25769,1,1,1138,1213,75
25770,0,0,46,0,-46
25771,0,0,74,0,-74
25772,1,0,92,0,-92
25773,0,0,21,0,-21
25774,1,0,22,0,-22
25775,1,1,538,1541,1003
25776,0,0,84,0,-84
25777,1,0,74,0,-74
25778,1,1,345,1364,1019
25779,1,0,56,0,-56
25780,1,0,33,0,-33
25781,0,0,22,0,-22
25782,1,1,229,1228,999
25783,0,0,2,0,-2
25784,1,0,119,0,-119
25785,0,0,127,0,-127
25786,1,0,147,0,-147
25787,0,0,8,0,-8
25788,0,0,28,0,-28
25789,1,1,1323,1815,492
25790,0,0,1,0,-1
25791,0,0,74,0,-74
25792,1,0,145,0,-145
25793,1,1,403,1532,1129
25794,1,0,39,0,-39
25795,1,0,34,0,-34
25796,1,1,1227,1372,145
25797,0,0,8,0,-8
25798,1,0,18,0,-18
25799,1,0,155,0,-155
25800,1,1,899,1696,797
25801,0,0,36,0,-36
25802,1,0,101,0,-101
25803,1,1,1556,1301,-255
25804,1,0,24,0,-24
25805,1,1,705,1372,667
25806,1,0,40,0,-40
25807,1,1,517,1685,1168
25808,0,0,66,0,-66
25809,1,0,12,0,-12
25810,0,0,3,0,-3
25811,1,0,1,0,-1
25812,0,0,82,0,-82
25813,1,1,125,1364,1239
25814,1,0,26,0,-26
25815,1,0,7,0,-7
25816,0,0,56,0,-56
25817,0,0,24,0,-24
25818,1,1,542,1210,668
25819,0,0,14,0,-14
25820,0,0,134,0,-134
25821,1,0,13,0,-13
25822,1,1,1260,1238,-22
25823,1,1,459,1365,906
25824,1,0,12,0,-12
25825,1,0,9,0,-9
25826,1,1,415,1734,1319
25827,1,0,5,0,-5
25828,1,1,203,1207,1004
25829,0,0,52,0,-52
25830,1,1,97,1435,1338
25831,0,0,19,0,-19
25832,1,1,362,1888,1526
25833,0,0,21,0,-21
25834,1,1,1488,1260,-228
25835,1,0,20,0,-20
25836,0,0,15,0,-15
25837,1,1,86,2721,2635
25838,0,0,79,0,-79
25839,1,1,416,1213,797
25840,1,1,266,1207,941
25841,1,0,36,0,-36
25842,1,0,30,0,-30
25843,0,0,84,0,-84
25844,0,0,72,0,-72
25845,1,1,500,2633,2133
25846,1,0,3,0,-3
25847,0,0,13,0,-13
25848,1,1,189,1668,1479
25849,0,0,10,0,-10
25850,1,1,480,1355,875
25851,0,0,82,0,-82
25852,0,0,6,0,-6
25853,1,0,96,0,-96
25854,1,0,13,0,-13
25855,0,0,40,0,-40
25856,0,0,24,0,-24
25857,1,1,758,1312,554
25858,1,1,379,1437,1058
25859,1,1,295,1538,1243
25860,1,1,72,1412,1340
25861,0,0,18,0,-18
25862,1,1,271,1613,1342
25863,1,1,872,2988,2116
25864,1,1,21,1340,1319
25865,0,0,160,0,-160
25866,1,0,39,0,-39
25867,0,0,49,0,-49
25868,1,1,824,1244,420
25869,1,1,256,2169,1913
25870,0,0,74,0,-74
25871,0,0,14,0,-14
25872,0,0,35,0,-35
25873,0,0,14,0,-14
25874,1,1,408,1521,1113
25875,0,0,61,0,-61
25876,0,0,53,0,-53
25877,0,0,42,0,-42
25878,1,1,912,1790,878
25879,1,0,7,0,-7
25880,1,0,73,0,-73
25881,1,1,565,1220,655
25882,0,0,1,0,-1
25883,0,0,53,0,-53
25884,0,0,77,0,-77
25885,0,0,39,0,-39
25886,1,0,8,0,-8
25887,0,0,89,0,-89
25888,1,0,57,0,-57
25889,1,0,8,0,-8
25890,1,0,30,0,-30
25891,0,0,23,0,-23
25892,1,1,476,1214,738
25893,1,0,27,0,-27
25894,0,0,35,0,-35
25895,0,0,4,0,-4
25896,1,1,1343,1478,135
25897,1,0,10,0,-10
25898,1,0,33,0,-33
25899,0,0,83,0,-83
25900,1,0,29,0,-29
25901,1,0,1,0,-1
25902,1,1,586,1326,740
25903,1,1,172,1570,1398
25904,0,0,26,0,-26
25905,1,1,603,1757,1154
25906,0,0,124,0,-124
25907,1,1,731,1421,690
25908,0,0,47,0,-47
25909,1,0,34,0,-34
25910,1,0,13,0,-13
25911,0,0,23,0,-23
25912,1,1,1185,1464,279
25913,0,0,30,0,-30
25914,1,1,26,1329,1303
25915,0,0,103,0,-103
25916,0,0,13,0,-13
25917,1,0,14,0,-14
25918,0,0,84,0,-84
25919,0,0,7,0,-7
25920,1,1,1043,1805,762
25921,1,1,266,2026,1760
25922,0,0,1,0,-1
25923,0,0,9,0,-9
25924,1,1,102,1212,1110
25925,0,0,30,0,-30
25926,0,0,117,0,-117
25927,1,1,40,2745,2705
25928,0,0,47,0,-47
25929,1,1,379,1528,1149
25930,1,1,125,1209,1084
25931,1,0,3,0,-3
25932,1,0,5,0,-5
25933,0,0,8,0,-8
25934,0,0,3,0,-3
25935,1,1,218,1263,1045
25936,1,0,8,0,-8
25937,1,0,31,0,-31
25938,0,0,99,0,-99
25939,1,1,338,1870,1532
25940,0,0,5,0,-5
25941,1,0,18,0,-18
25942,1,1,396,1605,1209
25943,0,0,56,0,-56
25944,0,0,129,0,-129
25945,0,0,12,0,-12
25946,1,1,226,1835,1609
25947,0,0,33,0,-33
25948,1,1,905,1235,330
25949,0,0,69,0,-69
25950,0,0,37,0,-37
25951,0,0,53,0,-53
25952,0,0,106,0,-106
25953,1,1,2474,1244,-1230
25954,1,0,26,0,-26
25955,1,1,828,1419,591
25956,0,0,60,0,-60
25957,1,1,56,1505,1449
25958,0,0,18,0,-18
25959,0,0,189,0,-189
25960,1,0,18,0,-18
25961,0,0,42,0,-42
25962,1,0,103,0,-103
25963,1,1,455,1589,1134
25964,0,0,30,0,-30
25965,1,0,16,0,-16
25966,0,0,69,0,-69
25967,1,1,828,1384,556
25968,1,0,95,0,-95
25969,1,0,8,0,-8
25970,1,0,2,0,-2
25971,0,0,1,0,-1
25972,1,0,53,0,-53
25973,0,0,23,0,-23
25974,1,0,0,0,0
25975,1,0,0,0,0
25976,0,0,63,0,-63
25977,0,0,70,0,-70
25978,1,0,5,0,-5
25979,0,0,6,0,-6
25980,1,1,266,1371,1105
25981,1,0,29,0,-29
25982,0,0,85,0,-85
25983,1,1,170,2655,2485
25984,0,0,45,0,-45
25985,1,1,650,1527,877
25986,1,0,2,0,-2
25987,1,0,15,0,-15
25988,0,0,44,0,-44
25989,1,1,60,1580,1520
25990,1,1,911,1667,756
25991,1,1,25,1293,1268
25992,1,1,203,1677,1474
25993,1,1,1122,2806,1684
25994,1,0,2,0,-2
25995,1,0,23,0,-23
25996,1,1,959,6142,5183
25997,1,0,60,0,-60
25998,1,0,7,0,-7
25999,0,0,31,0,-31
26000,0,0,4,0,-4
26001,1,0,162,0,-162
26002,0,0,0,0,0
26003,1,0,5,0,-5
26004,0,0,67,0,-67
26005,1,1,433,2859,2426
26006,1,0,11,0,-11
26007,1,0,24,0,-24
26008,1,1,922,1235,313
26009,0,0,47,0,-47
26010,1,0,44,0,-44
26011,1,1,150,1408,1258
26012,1,0,42,0,-42
26013,1,1,289,1277,988
26014,1,1,1243,1354,111
26015,0,0,9,0,-9
26016,1,0,100,0,-100
26017,0,0,8,0,-8
26018,1,1,2455,1779,-676
26019,1,0,81,0,-81
26020,0,0,61,0,-61
26021,1,0,8,0,-8
26022,1,1,165,1658,1493
26023,1,1,1935,1581,-354
26024,1,1,94,1274,1180
26025,1,1,129,1378,1249
26026,1,1,2137,1288,-849
26027,1,0,68,0,-68
26028,1,1,489,1304,815
26029,0,0,38,0,-38
26030,1,0,3,0,-3
26031,1,0,8,0,-8
26032,1,0,22,0,-22
26033,0,0,3,0,-3
26034,1,1,1191,1546,355
26035,0,0,34,0,-34
26036,1,0,13,0,-13
26037,1,0,44,0,-44
26038,1,1,158,5211,5053
26039,1,0,0,0,0
26040,1,1,803,1447,644
26041,0,0,97,0,-97
26042,0,0,14,0,-14
26043,1,1,983,1483,500
26044,1,0,77,0,-77
26045,1,1,192,1576,1384
26046,1,1,236,1730,1494
26047,1,1,2047,1210,-837
26048,0,0,66,0,-66
26049,1,0,0,0,0
26050,0,0,15,0,-15
26051,0,0,30,0,-30
26052,0,0,40,0,-40
26053,1,0,4,0,-4
26054,1,1,298,1343,1045
26055,1,1,1791,1422,-369
26056,0,0,34,0,-34
26057,1,1,68,1306,1238
26058,0,0,36,0,-36
26059,0,0,39,0,-39
26060,1,0,103,0,-103
26061,1,0,2,0,-2
26062,1,0,95,0,-95
26063,1,0,105,0,-105
26064,0,0,47,0,-47
26065,1,0,107,0,-107
26066,1,1,1202,1538,336
26067,1,1,325,1324,999
26068,0,0,31,0,-31
26069,1,1,110,1662,1552
26070,0,0,20,0,-20
26071,0,0,72,0,-72
26072,1,1,89,1528,1439
26073,0,0,64,0,-64
26074,1,1,570,1311,741
26075,0,0,9,0,-9
26076,1,1,1308,1354,46
26077,0,0,192,0,-192
26078,1,0,57,0,-57
26079,0,0,65,0,-65
26080,0,0,13,0,-13
26081,1,0,62,0,-62
26082,0,0,20,0,-20
26083,1,1,398,1656,1258
26084,1,0,36,0,-36
26085,1,0,31,0,-31
26086,1,1,1571,1305,-266
26087,1,0,23,0,-23
26088,1,1,314,1722,1408
26089,0,0,8,0,-8
26090,0,0,76,0,-76
26091,1,0,16,0,-16
26092,0,0,4,0,-4
26093,1,0,220,0,-220
26094,1,0,50,0,-50
26095,0,0,61,0,-61
26096,0,0,13,0,-13
26097,1,0,47,0,-47
26098,0,0,15,0,-15
26099,1,1,338,2820,2482
26100,1,1,332,1323,991
26101,0,0,143,0,-143
26102,1,1,300,1510,1210
26103,1,0,36,0,-36
26104,0,0,5,0,-5
26105,1,1,572,1508,936
26106,1,0,29,0,-29
26107,1,0,23,0,-23
26108,1,0,85,0,-85
26109,1,0,30,0,-30
26110,0,0,30,0,-30
26111,1,1,827,2282,1455
26112,0,0,5,0,-5
26113,1,0,13,0,-13
26114,1,0,17,0,-17
26115,0,0,10,0,-10
26116,1,0,14,0,-14
26117,1,1,371,1553,1182
26118,1,1,2018,1307,-711
26119,1,0,26,0,-26
26120,0,0,60,0,-60
26121,1,0,88,0,-88
26122,1,1,280,1442,1162
26123,1,0,11,0,-11
26124,1,1,791,1524,733
26125,0,0,4,0,-4
26126,0,0,10,0,-10
26127,0,0,40,0,-40
26128,1,1,24,1236,1212
26129,0,0,68,0,-68
26130,0,0,2,0,-2
26131,0,0,20,0,-20
26132,0,0,77,0,-77
26133,1,1,106,1388,1282
26134,1,0,0,0,0
26135,1,1,317,1408,1091
26136,1,0,3,0,-3
26137,0,0,177,0,-177
26138,1,0,84,0,-84
26139,0,0,19,0,-19
26140,1,0,2,0,-2
26141,0,0,19,0,-19
26142,1,0,25,0,-25
26143,0,0,49,0,-49
26144,1,0,15,0,-15
26145,1,0,52,0,-52
26146,1,0,46,0,-46
26147,0,0,37,0,-37
26148,1,1,1059,1702,643
26149,1,1,260,1572,1312
26150,1,0,29,0,-29
26151,1,0,93,0,-93
26152,0,0,45,0,-45
26153,1,1,119,1404,1285
26154,1,0,172,0,-172
26155,0,0,111,0,-111
26156,1,1,552,1844,1292
26157,0,0,28,0,-28
26158,1,1,169,1229,1060
26159,0,0,13,0,-13
26160,0,0,117,0,-117
26161,1,1,150,1650,1500
26162,1,1,167,1647,1480
26163,0,0,85,0,-85
26164,1,1,77,2098,2021
26165,0,0,13,0,-13
26166,0,0,9,0,-9
26167,0,0,20,0,-20
26168,1,0,11,0,-11
26169,0,0,139,0,-139
26170,1,1,411,1562,1151
26171,1,0,27,0,-27
26172,0,0,40,0,-40
26173,0,0,47,0,-47
26174,1,1,1010,2089,1079
26175,1,1,102,1220,1118
26176,0,0,0,0,0
26177,1,1,1314,1465,151
26178,1,0,8,0,-8
26179,1,1,297,1235,938
26180,1,0,18,0,-18
26181,1,1,214,1365,1151
26182,1,0,33,0,-33
26183,0,0,36,0,-36
26184,1,0,204,0,-204
26185,1,1,98,1539,1441
26186,1,1,234,2941,2707
26187,0,0,7,0,-7
26188,0,0,9,0,-9
26189,0,0,2,0,-2
26190,0,0,62,0,-62
26191,0,0,124,0,-124
26192,1,1,326,1371,1045
26193,0,0,56,0,-56
26194,0,0,51,0,-51
26195,1,1,1242,1451,209
26196,0,0,42,0,-42
26197,1,0,69,0,-69
26198,1,0,99,0,-99
26199,0,0,21,0,-21
26200,0,0,80,0,-80
26201,1,0,24,0,-24
26202,1,0,23,0,-23
26203,1,1,146,1217,1071
26204,0,0,22,0,-22
26205,0,0,21,0,-21
26206,1,1,535,1433,898
26207,1,1,226,1200,974
26208,0,0,7,0,-7
26209,1,1,820,1507,687
26210,1,1,1351,1281,-70
26211,0,0,43,0,-43
26212,1,1,61,1436,1375
26213,1,0,56,0,-56
26214,0,0,63,0,-63
26215,1,1,275,1802,1527
26216,1,1,270,1253,983
26217,1,1,547,1268,721
26218,1,0,15,0,-15
26219,1,0,38,0,-38
26220,0,0,27,0,-27
26221,1,1,325,1468,1143
26222,0,0,114,0,-114
26223,0,0,12,0,-12
26224,0,0,30,0,-30
26225,1,1,556,1337,781
26226,1,1,251,1710,1459
26227,1,1,83,2508,2425
26228,1,1,1053,1462,409
26229,0,0,219,0,-219
26230,1,1,532,2681,2149
26231,1,1,133,1327,1194
26232,0,0,38,0,-38
26233,1,1,1561,1234,-327
26234,0,0,41,0,-41
26235,0,0,53,0,-53
26236,1,1,502,1909,1407
26237,1,1,340,1561,1221
26238,0,0,47,0,-47
26239,0,0,9,0,-9
26240,0,0,97,0,-97
26241,1,0,84,0,-84
26242,0,0,0,0,0
26243,1,1,89,1402,1313
26244,0,0,39,0,-39
26245,1,0,76,0,-76
26246,0,0,93,0,-93
26247,1,0,37,0,-37
26248,1,0,10,0,-10
26249,0,0,8,0,-8
26250,0,0,20,0,-20
26251,1,1,1107,1200,93
26252,1,0,40,0,-40
26253,1,1,917,1536,619
26254,1,1,1209,1451,242
26255,1,1,24,1386,1362
26256,1,1,263,1230,967
26257,1,0,7,0,-7
26258,1,1,168,2067,1899
26259,0,0,9,0,-9
26260,1,1,26,1618,1592
26261,1,0,1,0,-1
26262,1,1,128,1380,1252
26263,0,0,77,0,-77
26264,0,0,12,0,-12
26265,1,1,188,1485,1297
26266,0,0,151,0,-151
26267,0,0,75,0,-75
26268,1,0,30,0,-30
26269,1,0,31,0,-31
26270,1,1,821,1319,498
26271,1,0,132,0,-132
26272,1,0,8,0,-8
26273,1,1,257,1438,1181
26274,0,0,60,0,-60
26275,0,0,129,0,-129
26276,1,0,22,0,-22
26277,0,0,61,0,-61
26278,1,0,120,0,-120
26279,0,0,85,0,-85
26280,1,0,31,0,-31
26281,0,0,25,0,-25
26282,0,0,3,0,-3
26283,1,1,667,1470,803
26284,1,0,15,0,-15
26285,1,1,752,1493,741
26286,0,0,67,0,-67
26287,0,0,21,0,-21
26288,0,0,118,0,-118
26289,1,0,4,0,-4
26290,1,0,53,0,-53
26291,1,1,40,1218,1178
26292,0,0,98,0,-98
26293,1,0,115,0,-115
26294,0,0,15,0,-15
26295,0,0,26,0,-26
26296,1,0,100,0,-100
26297,0,0,123,0,-123
26298,1,0,306,0,-306
26299,1,0,26,0,-26
26300,1,0,25,0,-25
26301,0,0,5,0,-5
26302,1,0,94,0,-94
26303,1,1,66,1246,1180
26304,1,1,69,1307,1238
26305,1,1,1387,1380,-7
26306,0,0,20,0,-20
26307,0,0,9,0,-9
26308,1,0,32,0,-32
26309,1,1,794,1448,654
26310,0,0,70,0,-70
26311,0,0,45,0,-45
26312,1,0,42,0,-42
26313,1,1,518,1457,939
26314,1,1,867,1224,357
26315,0,0,44,0,-44
26316,1,1,247,1398,1151
26317,1,0,26,0,-26
26318,1,1,205,2506,2301
26319,0,0,108,0,-108
26320,0,0,37,0,-37
26321,0,0,113,0,-113
26322,1,1,1632,1750,118
26323,1,0,26,0,-26
26324,0,0,6,0,-6
26325,1,0,25,0,-25
26326,1,1,623,1278,655
26327,1,0,26,0,-26
26328,0,0,124,0,-124
26329,0,0,91,0,-91
26330,1,1,15,1460,1445
26331,1,0,23,0,-23
26332,0,0,85,0,-85
26333,1,1,417,1570,1153
26334,1,0,26,0,-26
26335,1,0,24,0,-24
26336,0,0,10,0,-10
26337,0,0,52,0,-52
26338,1,0,32,0,-32
26339,1,0,28,0,-28
26340,1,1,554,1552,998
26341,0,0,15,0,-15
26342,0,0,34,0,-34
26343,0,0,7,0,-7
26344,1,0,25,0,-25
26345,0,0,14,0,-14
26346,1,0,34,0,-34
26347,1,1,219,1347,1128
26348,1,1,230,1580,1350
26349,1,1,321,1396,1075
26350,0,0,29,0,-29
26351,1,1,197,1517,1320
26352,1,0,0,0,0
26353,1,0,6,0,-6
26354,1,1,354,1225,871
26355,1,0,173,0,-173
26356,0,0,35,0,-35
26357,1,1,346,1674,1328
26358,0,0,11,0,-11
26359,1,0,30,0,-30
26360,1,1,369,1307,938
26361,1,1,87,1259,1172
26362,0,0,86,0,-86
26363,0,0,29,0,-29
26364,1,0,23,0,-23
26365,0,0,44,0,-44
26366,1,0,18,0,-18
26367,1,1,54,1541,1487
26368,0,0,32,0,-32
26369,0,0,28,0,-28
26370,1,0,14,0,-14
26371,1,1,1697,1676,-21
26372,0,0,40,0,-40
26373,1,1,1143,1337,194
26374,0,0,10,0,-10
26375,0,0,172,0,-172
26376,1,0,105,0,-105
26377,1,1,1017,1216,199
26378,1,0,38,0,-38
26379,1,0,220,0,-220
26380,0,0,61,0,-61
26381,0,0,107,0,-107
26382,1,0,61,0,-61
26383,1,0,37,0,-37
26384,1,1,52,1766,1714
26385,1,1,172,1216,1044
26386,1,0,134,0,-134
26387,1,1,125,2116,1991
26388,1,0,47,0,-47
26389,1,1,543,1568,1025
26390,1,1,251,1653,1402
26391,0,0,11,0,-11
26392,0,0,41,0,-41
26393,0,0,73,0,-73
26394,0,0,37,0,-37
26395,1,0,11,0,-11
26396,0,0,49,0,-49
26397,1,1,328,1263,935
26398,1,1,127,1291,1164
26399,0,0,83,0,-83
26400,0,0,73,0,-73
26401,1,1,425,1218,793
26402,1,0,84,0,-84
26403,1,1,257,1604,1347
26404,0,0,44,0,-44
26405,1,1,177,1340,1163
26406,1,0,100,0,-100
26407,1,1,222,1895,1673
26408,0,0,27,0,-27
26409,0,0,35,0,-35
26410,1,0,1,0,-1
26411,1,0,110,0,-110
26412,1,0,92,0,-92
26413,1,1,630,1706,1076
26414,1,0,182,0,-182
26415,1,1,728,1375,647
26416,1,0,24,0,-24
26417,1,0,20,0,-20
26418,0,0,20,0,-20
26419,1,1,199,1454,1255
26420,1,1,344,1791,1447
26421,0,0,15,0,-15
26422,1,0,36,0,-36
26423,1,0,18,0,-18
26424,1,1,331,1383,1052
26425,0,0,10,0,-10
26426,1,0,38,0,-38
26427,1,1,330,1318,988
26428,0,0,38,0,-38
26429,1,1,322,1503,1181
26430,1,1,435,1635,1200
26431,1,0,22,0,-22
26432,0,0,21,0,-21
26433,0,0,6,0,-6
26434,0,0,3,0,-3
26435,1,0,23,0,-23
26436,1,0,7,0,-7
26437,0,0,0,0,0
26438,0,0,24,0,-24
26439,1,0,0,0,0
26440,0,0,12,0,-12
26441,1,1,1339,1421,82
26442,0,0,29,0,-29
26443,1,0,104,0,-104
26444,1,1,715,1251,536
26445,0,0,172,0,-172
26446,1,1,1047,1216,169
26447,1,1,612,1309,697
26448,0,0,6,0,-6
26449,1,0,22,0,-22
26450,1,0,0,0,0
26451,1,0,7,0,-7
26452,1,1,127,1656,1529
26453,1,1,148,1385,1237
26454,1,1,86,1264,1178
26455,1,1,241,4213,3972
26456,1,1,91,1353,1262
26457,1,1,432,1257,825
26458,1,1,816,1246,430
26459,1,1,1140,1251,111
26460,1,0,93,0,-93
26461,1,0,39,0,-39
26462,0,0,90,0,-90
26463,1,1,921,1485,564
26464,0,0,97,0,-97
26465,1,0,37,0,-37
26466,0,0,7,0,-7
26467,1,1,717,1420,703
26468,0,0,79,0,-79
26469,1,0,14,0,-14
26470,0,0,13,0,-13
26471,1,0,176,0,-176
26472,0,0,138,0,-138
26473,0,0,47,0,-47
26474,1,1,188,2438,2250
26475,1,1,1160,1408,248
26476,1,1,343,1827,1484
26477,1,0,98,0,-98
26478,1,1,308,1702,1394
26479,0,0,182,0,-182
26480,1,1,1168,1352,184
26481,0,0,29,0,-29
26482,0,0,119,0,-119
26483,1,0,9,0,-9
26484,0,0,11,0,-11
26485,1,1,176,1596,1420
26486,0,0,3,0,-3
26487,1,1,212,1214,1002
26488,1,1,19,1324,1305
26489,0,0,75,0,-75
26490,1,1,238,1353,1115
26491,1,1,1043,1217,174
26492,1,1,335,1564,1229
26493,1,0,34,0,-34
26494,0,0,94,0,-94
26495,1,1,501,1908,1407
26496,1,0,108,0,-108
26497,0,0,69,0,-69
26498,1,0,15,0,-15
26499,1,0,3,0,-3
26500,1,0,96,0,-96
26501,1,0,11,0,-11
26502,1,0,7,0,-7
26503,1,1,771,1445,674
26504,1,0,18,0,-18
26505,0,0,129,0,-129
26506,0,0,25,0,-25
26507,0,0,13,0,-13
26508,1,1,857,2365,1508
26509,1,0,88,0,-88
26510,1,0,50,0,-50
26511,0,0,40,0,-40
26512,0,0,92,0,-92
26513,1,1,187,2521,2334
26514,1,1,61,1670,1609
26515,1,1,657,2701,2044
26516,1,1,968,1681,713
26517,0,0,64,0,-64
26518,0,0,136,0,-136
26519,1,1,1210,1561,351
26520,1,1,310,1230,920
26521,1,0,107,0,-107
26522,1,0,6,0,-6
26523,1,0,0,0,0
26524,1,0,7,0,-7
26525,1,1,576,1922,1346
26526,0,0,32,0,-32
26527,1,1,118,1987,1869
26528,0,0,61,0,-61
26529,1,0,14,0,-14
26530,0,0,26,0,-26
26531,1,0,114,0,-114
26532,1,0,61,0,-61
26533,1,1,625,1997,1372
26534,1,0,7,0,-7
26535,0,0,286,0,-286
26536,0,0,11,0,-11
26537,1,0,2,0,-2
26538,0,0,15,0,-15
26539,1,0,57,0,-57
26540,1,1,148,2199,2051
26541,1,0,90,0,-90
26542,1,0,5,0,-5
26543,0,0,74,0,-74
26544,0,0,40,0,-40
26545,1,0,52,0,-52
26546,1,0,2,0,-2
26547,1,0,307,0,-307
26548,1,1,1002,1621,619
26549,0,0,124,0,-124
26550,1,1,323,1981,1658
26551,0,0,29,0,-29
26552,1,0,37,0,-37
26553,1,1,185,1333,1148
26554,0,0,23,0,-23
26555,1,1,917,1264,347
26556,0,0,139,0,-139
26557,1,0,29,0,-29
26558,1,0,57,0,-57
26559,0,0,25,0,-25
26560,1,0,78,0,-78
26561,1,1,31,1279,1248
26562,1,0,85,0,-85
26563,0,0,119,0,-119
26564,0,0,22,0,-22
26565,1,1,722,1241,519
26566,1,1,237,1335,1098
26567,0,0,47,0,-47
26568,0,0,6,0,-6
26569,0,0,0,0,0
26570,1,0,41,0,-41
26571,1,0,2,0,-2
26572,0,0,39,0,-39
26573,1,0,38,0,-38
26574,0,0,41,0,-41
26575,1,0,45,0,-45
26576,0,0,0,0,0
26577,1,1,2731,1229,-1502
26578,1,0,13,0,-13
26579,0,0,12,0,-12
26580,1,1,161,1230,1069
26581,0,0,23,0,-23
26582,0,0,0,0,0
26583,1,1,502,1657,1155
26584,1,1,694,1367,673
26585,0,0,46,0,-46
26586,1,0,23,0,-23
26587,0,0,64,0,-64
26588,1,1,1560,1392,-168
26589,1,0,72,0,-72
26590,0,0,38,0,-38
26591,1,0,50,0,-50
26592,1,0,211,0,-211
26593,1,1,1287,1405,118
26594,1,1,326,2763,2437
26595,1,1,356,2890,2534
26596,1,0,4,0,-4
26597,0,0,44,0,-44
26598,1,1,562,1640,1078
26599,0,0,7,0,-7
26600,0,0,114,0,-114
26601,1,1,624,1432,808
26602,1,0,76,0,-76
26603,0,0,134,0,-134
26604,1,1,509,1469,960
26605,1,1,217,1459,1242
26606,0,0,21,0,-21
26607,0,0,101,0,-101
26608,1,1,160,1500,1340
26609,0,0,18,0,-18
26610,1,0,25,0,-25
26611,0,0,1,0,-1
26612,0,0,36,0,-36
26613,1,1,92,1683,1591
26614,1,1,266,1241,975
26615,0,0,38,0,-38
26616,1,1,15,1314,1299
26617,0,0,52,0,-52
26618,0,0,43,0,-43
26619,0,0,58,0,-58
26620,0,0,104,0,-104
26621,1,1,387,1206,819
26622,1,0,4,0,-4
26623,1,1,191,1321,1130
26624,1,0,23,0,-23
26625,1,0,55,0,-55
26626,0,0,66,0,-66
26627,0,0,20,0,-20
26628,1,0,6,0,-6
26629,1,1,166,1601,1435
26630,1,1,949,1414,465
26631,1,1,294,1323,1029
26632,1,0,101,0,-101
26633,1,1,869,2585,1716
26634,1,0,43,0,-43
26635,1,0,9,0,-9
26636,0,0,4,0,-4
26637,0,0,41,0,-41
26638,1,1,76,1293,1217
26639,1,1,630,1615,985
26640,1,1,116,2744,2628
26641,0,0,79,0,-79
26642,1,1,154,1228,1074
26643,1,0,20,0,-20
26644,1,0,5,0,-5
26645,1,0,19,0,-19
26646,1,0,37,0,-37
26647,1,0,43,0,-43
26648,1,0,25,0,-25
26649,0,0,0,0,0
26650,1,0,12,0,-12
26651,0,0,36,0,-36
26652,0,0,98,0,-98
26653,1,0,10,0,-10
26654,0,0,10,0,-10
26655,0,0,7,0,-7
26656,1,1,307,1286,979
26657,1,0,25,0,-25
26658,1,0,39,0,-39
26659,1,0,4,0,-4
26660,1,0,9,0,-9
26661,1,0,74,0,-74
26662,1,0,35,0,-35
26663,0,0,22,0,-22
26664,1,1,163,1552,1389
26665,0,0,5,0,-5
26666,0,0,20,0,-20
26667,1,0,7,0,-7
26668,0,0,3,0,-3
26669,0,0,48,0,-48
26670,0,0,161,0,-161
26671,1,0,38,0,-38
26672,0,0,42,0,-42
26673,0,0,47,0,-47
26674,0,0,6,0,-6
26675,1,1,921,1402,481
26676,1,1,165,1538,1373
26677,0,0,10,0,-10
26678,1,1,398,1787,1389
26679,0,0,37,0,-37
26680,1,1,365,1396,1031
26681,0,0,78,0,-78
26682,1,0,14,0,-14
26683,1,0,19,0,-19
26684,0,0,88,0,-88
26685,0,0,97,0,-97
26686,0,0,39,0,-39
26687,1,0,8,0,-8
26688,0,0,13,0,-13
26689,0,0,72,0,-72
26690,0,0,18,0,-18
26691,1,0,10,0,-10
26692,1,0,20,0,-20
26693,0,0,20,0,-20
26694,0,0,45,0,-45
26695,0,0,53,0,-53
26696,0,0,24,0,-24
26697,1,1,1167,1443,276
26698,0,0,14,0,-14
26699,1,1,1315,1952,637
26700,1,1,818,1634,816
26701,1,0,234,0,-234
26702,1,0,2,0,-2
26703,1,0,4,0,-4
26704,1,0,79,0,-79
26705,1,1,496,1849,1353
26706,1,0,16,0,-16
26707,0,0,12,0,-12
26708,0,0,10,0,-10
26709,1,0,27,0,-27
26710,0,0,14,0,-14
26711,0,0,45,0,-45
26712,1,0,1,0,-1
26713,0,0,29,0,-29
26714,0,0,6,0,-6
26715,1,0,40,0,-40
26716,0,0,34,0,-34
26717,1,0,64,0,-64
26718,0,0,37,0,-37
26719,1,0,59,0,-59
26720,0,0,3,0,-3
26721,1,1,165,1236,1071
26722,1,1,278,1402,1124
26723,0,0,48,0,-48
26724,1,0,33,0,-33
26725,1,1,481,1265,784
26726,1,1,947,1672,725
26727,1,1,2428,1902,-526
26728,0,0,74,0,-74
26729,0,0,15,0,-15
26730,1,0,3,0,-3
26731,1,0,63,0,-63
26732,1,0,121,0,-121
26733,1,0,16,0,-16
26734,1,1,328,1276,948
26735,0,0,77,0,-77
26736,0,0,95,0,-95
26737,1,1,110,1968,1858
26738,1,1,2068,2274,206
26739,0,0,49,0,-49
26740,1,0,53,0,-53
26741,1,0,67,0,-67
26742,1,1,67,1710,1643
26743,1,0,0,0,0
26744,0,0,5,0,-5
26745,1,1,266,1257,991
26746,0,0,112,0,-112
26747,1,0,32,0,-32
26748,1,1,165,2223,2058
26749,1,0,48,0,-48
26750,0,0,1,0,-1
26751,0,0,18,0,-18
26752,0,0,11,0,-11
26753,0,0,12,0,-12
26754,1,1,351,1831,1480
26755,1,1,83,1845,1762
26756,1,0,39,0,-39
26757,1,1,199,1646,1447
26758,1,0,30,0,-30
26759,0,0,44,0,-44
26760,1,0,5,0,-5
26761,0,0,32,0,-32
26762,1,1,1289,1466,177
26763,0,0,54,0,-54
26764,1,1,199,1235,1036
26765,1,0,265,0,-265
26766,1,0,46,0,-46
26767,1,0,62,0,-62
26768,1,1,783,1889,1106
26769,1,0,99,0,-99
26770,0,0,34,0,-34
26771,0,0,39,0,-39
26772,1,0,10,0,-10
26773,1,1,223,1397,1174
26774,0,0,0,0,0
26775,0,0,43,0,-43
26776,0,0,152,0,-152
26777,1,1,270,1640,1370
26778,1,0,14,0,-14
26779,1,1,930,4688,3758
26780,0,0,157,0,-157
26781,1,0,43,0,-43
26782,1,0,13,0,-13
26783,1,0,16,0,-16
26784,1,0,24,0,-24
26785,1,1,132,1453,1321
26786,1,0,115,0,-115
26787,1,0,283,0,-283
26788,1,0,9,0,-9
26789,0,0,33,0,-33
26790,1,1,214,1308,1094
26791,0,0,21,0,-21
26792,1,1,192,1241,1049
26793,1,1,274,1218,944
26794,1,0,35,0,-35
26795,1,1,389,1702,1313
26796,0,0,15,0,-15
26797,1,1,258,1631,1373
26798,1,0,27,0,-27
26799,1,1,134,1739,1605
26800,1,0,134,0,-134
26801,0,0,115,0,-115
26802,0,0,61,0,-61
26803,1,0,65,0,-65
26804,1,0,88,0,-88
26805,1,1,425,2907,2482
26806,1,0,21,0,-21
26807,1,1,565,1314,749
26808,1,0,20,0,-20
26809,1,1,287,1358,1071
26810,0,0,119,0,-119
26811,0,0,42,0,-42
26812,1,1,1047,1549,502
26813,0,0,18,0,-18
26814,1,1,64,1958,1894
26815,0,0,2,0,-2
26816,0,0,23,0,-23
26817,0,0,165,0,-165
26818,1,1,185,1572,1387
26819,1,0,29,0,-29
26820,1,0,39,0,-39
26821,0,0,58,0,-58
26822,0,0,35,0,-35
26823,0,0,99,0,-99
26824,0,0,44,0,-44
26825,1,1,660,1499,839
26826,1,1,729,1412,683
26827,1,1,181,1820,1639
26828,0,0,12,0,-12
26829,1,1,55,1314,1259
26830,1,1,390,1277,887
26831,1,1,1405,1316,-89
26832,1,0,30,0,-30
26833,1,1,380,2006,1626
26834,0,0,21,0,-21
26835,0,0,15,0,-15
26836,1,1,215,1252,1037
26837,0,0,47,0,-47
26838,1,0,30,0,-30
26839,1,0,40,0,-40
26840,0,0,20,0,-20
26841,0,0,95,0,-95
26842,1,0,10,0,-10
26843,1,0,21,0,-21
26844,1,1,883,1701,818
26845,0,0,103,0,-103
26846,1,1,678,1411,733
26847,1,0,1,0,-1
26848,0,0,104,0,-104
26849,0,0,79,0,-79
26850,1,0,26,0,-26
26851,1,1,161,1335,1174
26852,1,1,826,1474,648
26853,1,1,457,1471,1014
26854,0,0,10,0,-10
26855,1,0,80,0,-80
26856,1,0,11,0,-11
26857,1,0,8,0,-8
26858,0,0,113,0,-113
26859,0,0,45,0,-45
26860,1,0,14,0,-14
26861,1,0,7,0,-7
26862,1,0,10,0,-10
26863,0,0,273,0,-273
26864,0,0,19,0,-19
26865,1,1,499,2020,1521
26866,1,1,693,1344,651
26867,0,0,5,0,-5
26868,1,1,218,1483,1265
26869,1,0,24,0,-24
26870,0,0,7,0,-7
26871,0,0,21,0,-21
26872,0,0,243,0,-243
26873,1,0,70,0,-70
26874,0,0,64,0,-64
26875,0,0,10,0,-10
26876,0,0,48,0,-48
26877,1,0,25,0,-25
26878,0,0,16,0,-16
26879,1,1,483,2058,1575
26880,0,0,5,0,-5
26881,0,0,48,0,-48
26882,1,1,930,1263,333
26883,1,1,311,1320,1009
26884,1,1,1476,1228,-248
26885,1,0,153,0,-153
26886,1,1,562,1724,1162
26887,1,0,20,0,-20
26888,1,0,142,0,-142
26889,0,0,6,0,-6
26890,1,1,170,1307,1137
26891,1,0,2,0,-2
26892,0,0,167,0,-167
26893,1,1,129,1772,1643
26894,0,0,79,0,-79
26895,0,0,59,0,-59
26896,1,1,114,1686,1572
26897,0,0,112,0,-112
26898,0,0,6,0,-6
26899,1,0,3,0,-3
26900,1,1,347,1551,1204
26901,1,0,131,0,-131
26902,1,1,230,1948,1718
26903,1,1,1379,1300,-79
26904,1,0,76,0,-76
26905,1,1,826,1552,726
26906,1,0,1,0,-1
26907,1,1,197,1217,1020
26908,1,0,25,0,-25
26909,1,1,273,1260,987
26910,0,0,189,0,-189
26911,1,0,6,0,-6
26912,1,1,741,1403,662
26913,0,0,29,0,-29
26914,1,0,42,0,-42
26915,1,0,52,0,-52
26916,0,0,8,0,-8
26917,1,0,84,0,-84
26918,0,0,58,0,-58
26919,1,0,7,0,-7
26920,1,0,11,0,-11
26921,1,1,505,1484,979
26922,0,0,59,0,-59
26923,0,0,67,0,-67
26924,0,0,192,0,-192
26925,0,0,23,0,-23
26926,0,0,42,0,-42
26927,0,0,172,0,-172
26928,1,1,200,1325,1125
26929,1,0,31,0,-31
26930,1,1,42,1492,1450
26931,0,0,2,0,-2
26932,1,0,53,0,-53
26933,1,0,67,0,-67
26934,1,0,0,0,0
26935,1,1,179,1351,1172
26936,1,1,752,1467,715
26937,1,0,42,0,-42
26938,1,1,202,1233,1031
26939,0,0,28,0,-28
26940,0,0,42,0,-42
26941,0,0,34,0,-34
26942,0,0,29,0,-29
26943,1,0,89,0,-89
26944,1,0,30,0,-30
26945,0,0,271,0,-271
26946,1,0,14,0,-14
26947,1,1,300,1425,1125
26948,1,1,229,1642,1413
26949,0,0,17,0,-17
26950,0,0,9,0,-9
26951,0,0,49,0,-49
26952,1,0,19,0,-19
26953,1,1,977,2495,1518
26954,0,0,54,0,-54
26955,1,1,258,1244,986
26956,1,1,253,1379,1126
26957,0,0,44,0,-44
26958,0,0,33,0,-33
26959,1,1,1097,1240,143
26960,1,1,426,1543,1117
26961,0,0,18,0,-18
26962,1,1,974,1230,256
26963,0,0,12,0,-12
26964,0,0,2,0,-2
26965,0,0,59,0,-59
26966,1,0,128,0,-128
26967,1,1,162,1273,1111
26968,1,1,622,1467,845
26969,0,0,17,0,-17
26970,1,0,1,0,-1
26971,1,1,161,1207,1046
26972,1,1,578,1201,623
26973,1,0,8,0,-8
26974,1,1,1055,2066,1011
26975,1,1,363,1331,968
26976,0,0,29,0,-29
26977,1,1,396,1342,946
26978,1,0,15,0,-15
26979,0,0,41,0,-41
26980,1,1,810,1222,412
26981,0,0,50,0,-50
26982,0,0,7,0,-7
26983,1,1,336,1792,1456
26984,1,1,114,1222,1108
26985,0,0,11,0,-11
26986,1,0,14,0,-14
26987,1,0,10,0,-10
26988,1,1,21,1251,1230
26989,1,1,80,1456,1376
26990,0,0,17,0,-17
26991,0,0,35,0,-35
26992,1,0,114,0,-114
26993,1,1,1218,1215,-3
26994,1,1,453,1351,898
26995,0,0,2,0,-2
26996,0,0,81,0,-81
26997,1,0,8,0,-8
26998,1,0,1,0,-1
26999,1,0,16,0,-16
27000,0,0,43,0,-43
27001,0,0,4,0,-4
27002,1,0,15,0,-15
27003,1,0,30,0,-30
27004,0,0,78,0,-78
27005,0,0,80,0,-80
27006,1,0,85,0,-85
27007,0,0,55,0,-55
27008,1,1,899,1218,319
27009,0,0,103,0,-103
27010,0,0,28,0,-28
27011,1,0,150,0,-150
27012,1,0,471,0,-471
27013,0,0,127,0,-127
27014,0,0,21,0,-21
27015,0,0,79,0,-79
27016,1,0,157,0,-157
27017,1,0,20,0,-20
27018,0,0,2,0,-2
27019,0,0,29,0,-29
27020,1,1,906,2006,1100
27021,0,0,151,0,-151
27022,0,0,3,0,-3
27023,0,0,13,0,-13
27024,1,1,367,1264,897
27025,1,1,492,1377,885
27026,0,0,93,0,-93
27027,1,1,114,1729,1615
27028,1,0,56,0,-56
27029,1,1,455,1641,1186
27030,1,0,47,0,-47
27031,0,0,22,0,-22
27032,1,1,932,1698,766
27033,0,0,49,0,-49
27034,0,0,72,0,-72
27035,1,0,7,0,-7
27036,0,0,21,0,-21
27037,0,0,2,0,-2
27038,0,0,49,0,-49
27039,0,0,24,0,-24
27040,1,0,52,0,-52
27041,0,0,22,0,-22
27042,0,0,25,0,-25
27043,1,0,28,0,-28
27044,1,1,188,1566,1378
27045,1,1,1101,1426,325
27046,1,1,277,1234,957
27047,1,0,57,0,-57
27048,1,1,94,1404,1310
27049,1,1,1451,1362,-89
27050,1,1,1027,2196,1169
27051,0,0,43,0,-43
27052,1,1,350,1309,959
27053,1,0,20,0,-20
27054,1,1,239,1324,1085
27055,1,0,24,0,-24
27056,0,0,29,0,-29
27057,0,0,35,0,-35
27058,0,0,34,0,-34
27059,1,1,919,1276,357
27060,1,0,0,0,0
27061,1,0,8,0,-8
27062,0,0,98,0,-98
27063,1,1,129,1553,1424
27064,0,0,3,0,-3
27065,1,0,43,0,-43
27066,0,0,9,0,-9
27067,0,0,138,0,-138
27068,0,0,55,0,-55
27069,1,0,6,0,-6
27070,0,0,18,0,-18
27071,0,0,18,0,-18
27072,1,0,2,0,-2
27073,1,1,45,1428,1383
27074,1,1,790,2321,1531
27075,0,0,14,0,-14
27076,0,0,44,0,-44
27077,0,0,61,0,-61
27078,1,1,509,1887,1378
27079,1,1,262,1200,938
27080,1,0,27,0,-27
27081,0,0,15,0,-15
27082,0,0,78,0,-78
27083,1,0,32,0,-32
27084,0,0,122,0,-122
27085,1,0,11,0,-11
27086,1,0,105,0,-105
27087,0,0,21,0,-21
27088,1,1,772,1363,591
27089,1,1,160,1279,1119
27090,0,0,101,0,-101
27091,0,0,3,0,-3
27092,0,0,18,0,-18
27093,1,0,24,0,-24
27094,0,0,41,0,-41
27095,0,0,0,0,0
27096,0,0,24,0,-24
27097,1,0,16,0,-16
27098,0,0,202,0,-202
27099,1,0,12,0,-12
27100,1,1,277,1452,1175
27101,1,1,631,1540,909
27102,1,0,3,0,-3
27103,1,0,2,0,-2
27104,0,0,0,0,0
27105,1,0,52,0,-52
27106,0,0,5,0,-5
27107,0,0,21,0,-21
27108,1,1,760,1508,748
27109,1,0,147,0,-147
27110,0,0,42,0,-42
27111,1,0,90,0,-90
27112,1,0,36,0,-36
27113,0,0,51,0,-51
27114,1,0,269,0,-269
27115,0,0,6,0,-6
27116,1,0,21,0,-21
27117,0,0,6,0,-6
27118,1,0,12,0,-12
27119,1,1,378,1336,958
27120,1,0,20,0,-20
27121,1,0,0,0,0
27122,0,0,5,0,-5
27123,1,1,306,1346,1040
27124,1,1,244,1492,1248
27125,1,1,274,3402,3128
27126,1,0,33,0,-33
27127,0,0,12,0,-12
27128,0,0,38,0,-38
27129,1,0,28,0,-28
27130,1,0,65,0,-65
27131,1,0,107,0,-107
27132,1,1,3891,1705,-2186
27133,1,1,765,1211,446
27134,1,0,51,0,-51
27135,0,0,66,0,-66
27136,1,1,446,2491,2045
27137,1,1,1151,1487,336
27138,0,0,30,0,-30
27139,1,0,110,0,-110
27140,1,1,525,1728,1203
27141,1,1,211,1227,1016
27142,1,1,848,1354,506
27143,0,0,270,0,-270
27144,0,0,26,0,-26
27145,0,0,81,0,-81
27146,1,1,711,1213,502
27147,1,0,29,0,-29
27148,1,0,88,0,-88
27149,0,0,46,0,-46
27150,1,1,269,1742,1473
27151,1,0,43,0,-43
27152,1,0,105,0,-105
27153,1,1,891,1769,878
27154,0,0,7,0,-7
27155,0,0,1,0,-1
27156,1,0,11,0,-11
27157,1,1,59,1752,1693
27158,1,1,517,1291,774
27159,1,0,114,0,-114
27160,0,0,23,0,-23
27161,0,0,9,0,-9
27162,1,1,1751,3159,1408
27163,1,0,15,0,-15
27164,0,0,29,0,-29
27165,1,1,71,1307,1236
27166,1,0,12,0,-12
27167,1,0,80,0,-80
27168,0,0,42,0,-42
27169,0,0,105,0,-105
27170,1,1,829,2854,2025
27171,1,1,1111,1333,222
27172,0,0,76,0,-76
27173,0,0,43,0,-43
27174,0,0,3,0,-3
27175,1,1,63,2034,1971
27176,0,0,48,0,-48
27177,0,0,45,0,-45
27178,1,0,9,0,-9
27179,0,0,76,0,-76
27180,1,0,60,0,-60
27181,1,1,203,1358,1155
27182,1,0,50,0,-50
27183,0,0,57,0,-57
27184,0,0,38,0,-38
27185,0,0,57,0,-57
27186,1,1,481,1718,1237
27187,0,0,0,0,0
27188,1,1,574,1481,907
27189,1,0,68,0,-68
27190,0,0,137,0,-137
27191,1,1,470,1848,1378
27192,0,0,83,0,-83
27193,0,0,2,0,-2
27194,1,0,1,0,-1
27195,0,0,143,0,-143
27196,1,0,136,0,-136
27197,1,0,3,0,-3
27198,1,0,135,0,-135
27199,1,1,14,2173,2159
27200,1,1,629,1280,651
27201,1,0,21,0,-21
27202,1,1,440,1241,801
27203,0,0,16,0,-16
27204,0,0,9,0,-9
27205,1,0,9,0,-9
27206,1,1,718,1414,696
27207,0,0,162,0,-162
27208,1,0,111,0,-111
27209,0,0,110,0,-110
27210,1,0,4,0,-4
27211,0,0,57,0,-57
27212,0,0,42,0,-42
27213,0,0,234,0,-234
27214,0,0,43,0,-43
27215,0,0,9,0,-9
27216,0,0,3,0,-3
27217,1,0,74,0,-74
27218,0,0,7,0,-7
27219,0,0,42,0,-42
27220,0,0,222,0,-222
27221,1,1,437,2691,2254
27222,1,1,230,1277,1047
27223,0,0,19,0,-19
27224,1,0,106,0,-106
27225,1,0,17,0,-17
27226,1,1,3282,1329,-1953
27227,0,0,56,0,-56
27228,1,0,64,0,-64
27229,0,0,3,0,-3
27230,1,1,591,1359,768
27231,1,1,588,1482,894
27232,0,0,32,0,-32
27233,1,1,431,1322,891
27234,0,0,14,0,-14
27235,1,1,168,2299,2131
27236,1,1,328,1378,1050
27237,1,1,461,1301,840
27238,1,0,1,0,-1
27239,0,0,48,0,-48
27240,1,0,8,0,-8
27241,1,0,97,0,-97
27242,1,0,6,0,-6
27243,1,1,802,1327,525
27244,0,0,10,0,-10
27245,1,0,22,0,-22
27246,1,1,75,1243,1168
27247,0,0,16,0,-16
27248,1,0,78,0,-78
27249,0,0,53,0,-53
27250,0,0,11,0,-11
27251,0,0,33,0,-33
27252,1,0,84,0,-84
27253,1,0,65,0,-65
27254,1,1,1333,1511,178
27255,0,0,118,0,-118
27256,0,0,99,0,-99
27257,1,1,1761,1256,-505
27258,0,0,28,0,-28
27259,0,0,59,0,-59
27260,1,0,32,0,-32
27261,1,0,123,0,-123
27262,0,0,158,0,-158
27263,1,1,2690,1530,-1160
27264,1,1,1588,1459,-129
27265,0,0,26,0,-26
27266,1,0,12,0,-12
27267,1,0,2,0,-2
27268,1,1,1460,1367,-93
27269,1,1,876,1584,708
27270,0,0,2,0,-2
27271,1,0,33,0,-33
27272,1,1,57,1233,1176
27273,1,0,29,0,-29
27274,0,0,38,0,-38
27275,0,0,59,0,-59
27276,1,1,1018,3629,2611
27277,0,0,14,0,-14
27278,1,0,30,0,-30
27279,0,0,6,0,-6
27280,1,0,50,0,-50
27281,1,1,420,1208,788
27282,1,0,50,0,-50
27283,1,1,340,1773,1433
27284,1,0,87,0,-87
27285,1,1,186,1540,1354
27286,1,0,26,0,-26
27287,1,0,5,0,-5
27288,1,1,7,1296,1289
27289,1,1,890,1478,588
27290,1,1,870,1340,470
27291,0,0,45,0,-45
27292,0,0,58,0,-58
27293,0,0,36,0,-36
27294,1,1,143,1949,1806
27295,1,0,16,0,-16
27296,1,0,100,0,-100
27297,0,0,85,0,-85
27298,1,0,43,0,-43
27299,1,0,75,0,-75
27300,1,0,110,0,-110
27301,0,0,0,0,0
27302,0,0,52,0,-52
27303,1,1,151,1204,1053
27304,0,0,13,0,-13
27305,1,1,2476,1652,-824
27306,0,0,6,0,-6
27307,0,0,43,0,-43
27308,1,1,1096,1799,703
27309,1,0,56,0,-56
27310,1,1,402,1641,1239
27311,1,0,6,0,-6
27312,0,0,103,0,-103
27313,0,0,36,0,-36
27314,1,1,296,2239,1943
27315,1,0,3,0,-3
27316,0,0,87,0,-87
27317,0,0,66,0,-66
27318,1,0,25,0,-25
27319,0,0,11,0,-11
27320,0,0,25,0,-25
27321,0,0,96,0,-96
27322,1,1,316,1366,1050
27323,0,0,14,0,-14
27324,1,0,38,0,-38
27325,0,0,50,0,-50
27326,0,0,79,0,-79
27327,0,0,8,0,-8
27328,1,0,6,0,-6
27329,0,0,6,0,-6
27330,0,0,14,0,-14
27331,0,0,26,0,-26
27332,1,1,931,1599,668
27333,1,0,119,0,-119
27334,1,0,24,0,-24
27335,1,1,229,1276,1047
27336,0,0,33,0,-33
27337,1,1,603,1566,963
27338,1,1,398,1676,1278
27339,1,1,3417,2321,-1096
27340,1,1,258,1283,1025
27341,0,0,29,0,-29
27342,1,0,22,0,-22
27343,1,0,12,0,-12
27344,1,1,1497,1306,-191
27345,1,0,53,0,-53
27346,0,0,9,0,-9
27347,1,1,549,1394,845
27348,1,0,24,0,-24
27349,1,1,136,1390,1254
27350,0,0,92,0,-92
27351,1,0,9,0,-9
27352,1,0,40,0,-40
27353,1,1,415,1215,800
27354,1,0,106,0,-106
27355,1,1,575,1716,1141
27356,0,0,7,0,-7
27357,1,0,26,0,-26
27358,0,0,14,0,-14
27359,1,1,411,1402,991
27360,0,0,36,0,-36
27361,1,0,27,0,-27
27362,1,1,191,2253,2062
27363,1,1,513,1547,1034
27364,1,1,92,1491,1399
27365,1,1,128,2817,2689
27366,0,0,44,0,-44
27367,1,1,355,1715,1360
27368,1,0,181,0,-181
27369,0,0,44,0,-44
27370,1,1,569,1838,1269
27371,0,0,117,0,-117
27372,1,0,192,0,-192
27373,0,0,19,0,-19
27374,0,0,159,0,-159
27375,0,0,3,0,-3
27376,0,0,4,0,-4
27377,1,1,170,1348,1178
27378,1,0,49,0,-49
27379,1,1,1730,1433,-297
27380,1,0,70,0,-70
27381,0,0,91,0,-91
27382,1,0,75,0,-75
27383,1,0,4,0,-4
27384,1,1,1213,1293,80
27385,1,1,58,1271,1213
27386,0,0,24,0,-24
27387,1,0,122,0,-122
27388,0,0,91,0,-91
27389,0,0,72,0,-72
27390,1,1,1407,1912,505
27391,0,0,12,0,-12
27392,1,1,235,3329,3094
27393,1,1,219,1395,1176
27394,0,0,3,0,-3
27395,1,1,849,1339,490
27396,0,0,28,0,-28
27397,1,0,84,0,-84
27398,0,0,47,0,-47
27399,1,1,312,1681,1369
27400,1,1,445,1399,954
27401,1,1,151,1392,1241
27402,0,0,12,0,-12
27403,0,0,7,0,-7
27404,1,0,252,0,-252
27405,1,0,10,0,-10
27406,0,0,10,0,-10
27407,1,0,5,0,-5
27408,1,1,361,1225,864
27409,1,0,34,0,-34
27410,0,0,79,0,-79
27411,1,1,470,1506,1036
27412,0,0,138,0,-138
27413,1,1,657,1278,621
27414,1,1,182,1817,1635
27415,0,0,147,0,-147
27416,0,0,12,0,-12
27417,1,1,1492,2159,667
27418,0,0,23,0,-23
27419,0,0,155,0,-155
27420,1,1,556,1200,644
27421,1,1,162,1300,1138
27422,1,1,992,3144,2152
27423,1,0,40,0,-40
27424,1,1,647,1490,843
27425,1,1,779,1334,555
27426,0,0,89,0,-89
27427,1,1,255,1304,1049
27428,1,0,9,0,-9
27429,1,1,59,1807,1748
27430,0,0,19,0,-19
27431,1,0,113,0,-113
27432,1,0,2,0,-2
27433,0,0,21,0,-21
27434,1,0,56,0,-56
27435,1,0,2,0,-2
27436,1,1,602,1389,787
27437,1,1,395,1300,905
27438,0,0,61,0,-61
27439,0,0,5,0,-5
27440,1,1,22,1522,1500
27441,0,0,112,0,-112
27442,1,0,17,0,-17
27443,1,0,195,0,-195
27444,0,0,2,0,-2
27445,1,0,22,0,-22
27446,1,1,55,1596,1541
27447,1,1,273,1319,1046
27448,1,0,98,0,-98
27449,1,1,633,1689,1056
27450,1,0,16,0,-16
27451,1,0,29,0,-29
27452,1,1,237,1649,1412
27453,1,0,34,0,-34
27454,1,1,720,1220,500
27455,1,1,536,1219,683
27456,0,0,22,0,-22
27457,1,1,611,1228,617
27458,0,0,64,0,-64
27459,0,0,2,0,-2
27460,0,0,195,0,-195
27461,1,0,10,0,-10
27462,1,1,215,1471,1256
27463,0,0,90,0,-90
27464,1,1,78,1429,1351
27465,1,1,200,1754,1554
27466,0,0,18,0,-18
27467,0,0,45,0,-45
27468,0,0,22,0,-22
27469,1,1,532,1230,698
27470,0,0,96,0,-96
27471,0,0,10,0,-10
27472,1,0,80,0,-80
27473,1,0,3,0,-3
27474,1,0,41,0,-41
27475,0,0,98,0,-98
27476,1,0,64,0,-64
27477,1,0,73,0,-73
27478,0,0,27,0,-27
27479,0,0,53,0,-53
27480,0,0,1,0,-1
27481,0,0,96,0,-96
27482,0,0,12,0,-12
27483,1,0,79,0,-79
27484,0,0,53,0,-53
27485,1,1,103,1211,1108
27486,0,0,68,0,-68
27487,1,1,151,1294,1143
27488,0,0,29,0,-29
27489,0,0,21,0,-21
27490,0,0,29,0,-29
27491,1,0,30,0,-30
27492,0,0,191,0,-191
27493,1,0,162,0,-162
27494,1,1,1652,1406,-246
27495,1,0,61,0,-61
27496,1,1,446,2217,1771
27497,1,0,99,0,-99
27498,1,1,163,1200,1037
27499,0,0,112,0,-112
27500,1,1,172,1351,1179
27501,1,1,560,1232,672
27502,0,0,13,0,-13
27503,1,1,1987,1365,-622
27504,0,0,104,0,-104
27505,1,1,179,1653,1474
27506,1,1,432,1649,1217
27507,1,0,14,0,-14
27508,1,0,85,0,-85
27509,1,1,602,1640,1038
27510,1,1,437,1212,775
27511,0,0,17,0,-17
27512,1,1,361,1703,1342
27513,1,0,87,0,-87
27514,1,0,103,0,-103
27515,0,0,13,0,-13
27516,1,0,29,0,-29
27517,1,1,70,1230,1160
27518,0,0,18,0,-18
27519,0,0,26,0,-26
27520,1,1,301,1961,1660
27521,0,0,11,0,-11
27522,1,1,1281,1380,99
27523,0,0,23,0,-23
27524,1,0,63,0,-63
27525,0,0,3,0,-3
27526,1,1,829,1273,444
27527,1,1,283,2386,2103
27528,1,1,1591,1519,-72
27529,0,0,53,0,-53
27530,1,1,579,1274,695
27531,0,0,98,0,-98
27532,1,1,743,2018,1275
27533,1,1,982,1320,338
27534,1,0,45,0,-45
27535,0,0,115,0,-115
27536,1,0,1,0,-1
27537,1,0,176,0,-176
27538,0,0,24,0,-24
27539,0,0,56,0,-56
27540,1,1,129,1272,1143
27541,1,0,160,0,-160
27542,0,0,47,0,-47
27543,1,1,2260,1204,-1056
27544,0,0,62,0,-62
27545,0,0,25,0,-25
27546,1,1,400,2101,1701
27547,1,1,78,1217,1139
27548,1,0,47,0,-47
27549,0,0,52,0,-52
27550,0,0,34,0,-34
27551,1,1,129,1203,1074
27552,1,1,2071,1528,-543
27553,0,0,5,0,-5
27554,1,1,44,2447,2403
27555,0,0,26,0,-26
27556,1,1,427,3266,2839
27557,1,0,8,0,-8
27558,0,0,65,0,-65
27559,1,1,115,1559,1444
27560,0,0,51,0,-51
27561,1,0,16,0,-16
27562,0,0,15,0,-15
27563,1,1,245,1495,1250
27564,1,1,112,1349,1237
27565,1,1,184,1899,1715
27566,0,0,39,0,-39
27567,1,1,96,2015,1919
27568,1,1,1273,1450,177
27569,1,1,198,1632,1434
27570,1,1,431,1255,824
27571,0,0,36,0,-36
27572,0,0,47,0,-47
27573,0,0,50,0,-50
27574,1,0,39,0,-39
27575,1,0,32,0,-32
27576,1,0,104,0,-104
27577,0,0,144,0,-144
27578,1,1,574,1480,906
27579,1,1,361,1409,1048
27580,1,1,375,1237,862
27581,0,0,16,0,-16
27582,1,0,0,0,0
27583,0,0,21,0,-21
27584,0,0,48,0,-48
27585,0,0,15,0,-15
27586,0,0,41,0,-41
27587,0,0,10,0,-10
27588,1,1,916,1215,299
27589,1,0,26,0,-26
27590,1,1,479,1575,1096
27591,1,0,391,0,-391
27592,1,0,22,0,-22
27593,1,1,104,4156,4052
27594,1,0,12,0,-12
27595,0,0,80,0,-80
27596,1,0,44,0,-44
27597,0,0,2,0,-2
27598,1,0,34,0,-34
27599,0,0,10,0,-10
27600,0,0,9,0,-9
27601,1,0,194,0,-194
27602,1,1,427,1781,1354
27603,0,0,47,0,-47
27604,1,0,49,0,-49
27605,0,0,20,0,-20
27606,1,0,202,0,-202
27607,0,0,14,0,-14
27608,0,0,22,0,-22
27609,0,0,21,0,-21
27610,1,1,728,1290,562
27611,1,1,1330,2943,1613
27612,1,1,936,1628,692
27613,1,0,66,0,-66
27614,1,1,508,1340,832
27615,1,0,29,0,-29
27616,0,0,107,0,-107
27617,0,0,44,0,-44
27618,0,0,25,0,-25
27619,0,0,0,0,0
27620,1,0,15,0,-15
27621,0,0,18,0,-18
27622,0,0,71,0,-71
27623,1,0,31,0,-31
27624,0,0,22,0,-22
27625,1,0,5,0,-5
27626,0,0,22,0,-22
27627,1,1,144,2634,2490
27628,1,0,13,0,-13
27629,1,1,363,1736,1373
27630,0,0,5,0,-5
27631,1,1,275,1221,946
27632,0,0,61,0,-61
27633,0,0,84,0,-84
27634,1,1,82,1243,1161
27635,0,0,19,0,-19
27636,0,0,16,0,-16
27637,1,1,216,1684,1468
27638,0,0,7,0,-7
27639,1,1,603,1356,753
27640,1,0,63,0,-63
27641,1,1,843,1294,451
27642,1,1,1172,1482,310
27643,1,1,146,1362,1216
27644,1,0,73,0,-73
27645,0,0,113,0,-113
27646,1,1,674,2755,2081
27647,1,0,74,0,-74
27648,1,0,21,0,-21
27649,1,1,205,1447,1242
27650,0,0,34,0,-34
27651,0,0,11,0,-11
27652,0,0,5,0,-5
27653,0,0,10,0,-10
27654,1,1,142,1300,1158
27655,0,0,43,0,-43
27656,1,0,31,0,-31
27657,0,0,56,0,-56
27658,1,0,1,0,-1
27659,1,1,798,1248,450
27660,1,0,5,0,-5
27661,1,1,564,1248,684
27662,0,0,84,0,-84
27663,1,0,42,0,-42
27664,1,0,26,0,-26
27665,1,1,265,1388,1123
27666,1,1,438,1508,1070
27667,0,0,68,0,-68
27668,0,0,84,0,-84
27669,0,0,90,0,-90
27670,1,0,315,0,-315
27671,1,0,235,0,-235
27672,1,0,75,0,-75
27673,1,1,919,2148,1229
27674,0,0,80,0,-80
27675,0,0,117,0,-117
27676,1,0,85,0,-85
27677,1,0,55,0,-55
27678,1,1,56,1274,1218
27679,0,0,14,0,-14
27680,1,1,396,2238,1842
27681,0,0,86,0,-86
27682,0,0,45,0,-45
27683,1,0,33,0,-33
27684,0,0,52,0,-52
27685,0,0,9,0,-9
27686,0,0,87,0,-87
27687,1,1,945,1224,279
27688,1,1,203,1242,1039
27689,1,1,84,1283,1199
27690,1,0,76,0,-76
27691,1,1,485,3438,2953
27692,0,0,84,0,-84
27693,1,1,112,1321,1209
27694,1,1,125,1443,1318
27695,1,1,236,1332,1096
27696,1,0,8,0,-8
27697,1,0,2,0,-2
27698,0,0,169,0,-169
27699,1,1,1400,1284,-116
27700,1,0,6,0,-6
27701,1,0,35,0,-35
27702,1,1,897,2632,1735
27703,1,0,92,0,-92
27704,0,0,81,0,-81
27705,0,0,13,0,-13
27706,0,0,24,0,-24
27707,1,1,765,7078,6313
27708,1,1,500,1268,768
27709,0,0,8,0,-8
27710,1,1,266,1347,1081
27711,1,0,59,0,-59
27712,1,0,84,0,-84
27713,1,1,148,1606,1458
27714,1,1,887,1628,741
27715,0,0,25,0,-25
27716,0,0,9,0,-9
27717,0,0,5,0,-5
27718,1,1,112,1234,1122
27719,1,0,29,0,-29
27720,1,1,380,2118,1738
27721,0,0,10,0,-10
27722,0,0,79,0,-79
27723,0,0,122,0,-122
27724,1,0,32,0,-32
27725,0,0,65,0,-65
27726,0,0,5,0,-5
27727,1,1,107,1572,1465
27728,1,0,72,0,-72
27729,0,0,35,0,-35
27730,0,0,77,0,-77
27731,0,0,129,0,-129
27732,0,0,114,0,-114
27733,1,1,332,1710,1378
27734,0,0,28,0,-28
27735,1,0,28,0,-28
27736,1,1,855,1913,1058
27737,0,0,18,0,-18
27738,1,1,370,1303,933
27739,1,1,1787,1888,101
27740,0,0,57,0,-57
27741,1,1,144,1835,1691
27742,1,0,0,0,0
27743,0,0,1,0,-1
27744,1,0,38,0,-38
27745,1,1,375,1708,1333
27746,0,0,96,0,-96
27747,0,0,30,0,-30
27748,0,0,18,0,-18
27749,1,0,41,0,-41
27750,0,0,210,0,-210
27751,1,1,142,1231,1089
27752,1,1,104,1249,1145
27753,1,1,297,1388,1091
27754,1,1,441,1221,780
27755,1,1,653,1226,573
27756,0,0,2,0,-2
27757,0,0,49,0,-49
27758,1,0,104,0,-104
27759,0,0,20,0,-20
27760,1,1,925,1878,953
27761,1,1,467,1296,829
27762,0,0,40,0,-40
27763,0,0,43,0,-43
27764,0,0,121,0,-121
27765,1,0,32,0,-32
27766,1,0,73,0,-73
27767,0,0,23,0,-23
27768,0,0,38,0,-38
27769,0,0,0,0,0
27770,0,0,24,0,-24
27771,1,1,643,1272,629
27772,1,1,294,1694,1400
27773,0,0,175,0,-175
27774,1,0,34,0,-34
27775,1,1,179,1320,1141
27776,0,0,1,0,-1
27777,0,0,257,0,-257
27778,1,0,64,0,-64
27779,0,0,20,0,-20
27780,1,0,4,0,-4
27781,1,0,92,0,-92
27782,0,0,36,0,-36
27783,1,0,10,0,-10
27784,1,0,13,0,-13
27785,1,1,523,1455,932
27786,0,0,24,0,-24
27787,1,1,332,1609,1277
27788,1,0,126,0,-126
27789,0,0,31,0,-31
27790,1,0,37,0,-37
27791,1,1,695,1881,1186
27792,0,0,1,0,-1
27793,1,0,37,0,-37
27794,1,1,1260,1408,148
27795,1,0,55,0,-55
27796,1,0,20,0,-20
27797,1,1,1154,1361,207
27798,0,0,82,0,-82
27799,1,0,6,0,-6
27800,0,0,124,0,-124
27801,1,1,624,1670,1046
27802,1,1,59,1393,1334
27803,0,0,35,0,-35
27804,1,1,570,1905,1335
27805,1,1,1039,1589,550
27806,1,0,134,0,-134
27807,1,0,24,0,-24
27808,1,0,4,0,-4
27809,0,0,1,0,-1
27810,0,0,9,0,-9
27811,0,0,44,0,-44
27812,1,1,772,1393,621
27813,1,0,21,0,-21
27814,1,0,84,0,-84
27815,0,0,30,0,-30
27816,1,1,435,1212,777
27817,0,0,51,0,-51
27818,1,1,518,1326,808
27819,0,0,56,0,-56
27820,0,0,69,0,-69
27821,1,0,128,0,-128
27822,1,1,39,2068,2029
27823,1,1,890,1498,608
27824,1,0,57,0,-57
27825,0,0,10,0,-10
27826,1,1,212,1460,1248
27827,1,0,164,0,-164
27828,0,0,33,0,-33
27829,1,1,645,1320,675
27830,1,1,108,1894,1786
27831,0,0,64,0,-64
27832,1,1,3059,1541,-1518
27833,1,0,69,0,-69
27834,0,0,8,0,-8
27835,1,1,363,1337,974
27836,0,0,112,0,-112
27837,1,1,54,1288,1234
27838,0,0,32,0,-32
27839,1,1,834,1538,704
27840,0,0,37,0,-37
27841,1,0,78,0,-78
27842,1,1,311,1201,890
27843,0,0,97,0,-97
27844,1,1,1221,1490,269
27845,1,1,576,1262,686
27846,0,0,181,0,-181
27847,1,1,737,1410,673
27848,1,0,53,0,-53
27849,1,0,125,0,-125
27850,1,1,430,1514,1084
27851,1,1,581,1451,870
27852,0,0,69,0,-69
27853,1,0,71,0,-71
27854,1,1,452,1353,901
27855,1,1,1167,1202,35
27856,1,1,316,2631,2315
27857,0,0,58,0,-58
27858,1,1,249,2463,2214
27859,1,1,463,1872,1409
27860,0,0,11,0,-11
27861,1,1,1394,1393,-1
27862,0,0,186,0,-186
27863,0,0,47,0,-47
27864,1,1,133,1273,1140
27865,1,0,16,0,-16
27866,1,0,101,0,-101
27867,0,0,114,0,-114
27868,1,0,12,0,-12
27869,1,1,374,1240,866
27870,1,1,303,1243,940
27871,0,0,10,0,-10
27872,0,0,109,0,-109
27873,1,0,26,0,-26
27874,0,0,62,0,-62
27875,1,1,790,1469,679
27876,1,1,547,1426,879
27877,1,0,28,0,-28
27878,1,1,208,1276,1068
27879,1,0,25,0,-25
27880,0,0,55,0,-55
27881,1,1,473,1607,1134
27882,1,0,13,0,-13
27883,1,0,90,0,-90
27884,1,0,0,0,0
27885,1,0,14,0,-14
27886,1,1,92,1692,1600
27887,0,0,44,0,-44
27888,0,0,73,0,-73
27889,1,1,1243,1272,29
27890,0,0,144,0,-144
27891,1,0,67,0,-67
27892,1,0,48,0,-48
27893,1,1,1321,1534,213
27894,1,1,311,1234,923
27895,1,1,46,1776,1730
27896,1,0,0,0,0
27897,0,0,33,0,-33
27898,0,0,28,0,-28
27899,1,1,74,1577,1503
27900,1,0,49,0,-49
27901,0,0,41,0,-41
27902,1,1,665,1415,750
27903,0,0,60,0,-60
27904,1,0,153,0,-153
27905,1,1,895,2016,1121
27906,1,0,19,0,-19
27907,0,0,100,0,-100
27908,1,0,46,0,-46
27909,0,0,9,0,-9
27910,1,0,11,0,-11
27911,1,0,34,0,-34
27912,0,0,18,0,-18
27913,1,1,611,1761,1150
27914,1,1,821,1385,564
27915,1,0,32,0,-32
27916,1,1,101,2193,2092
27917,1,0,59,0,-59
27918,1,0,52,0,-52
27919,1,1,51,1551,1500
27920,1,0,18,0,-18
27921,1,0,28,0,-28
27922,1,0,45,0,-45
27923,0,0,72,0,-72
27924,1,1,242,1270,1028
27925,1,1,337,1760,1423
27926,0,0,47,0,-47
27927,0,0,59,0,-59
27928,0,0,6,0,-6
27929,0,0,42,0,-42
27930,1,0,11,0,-11
27931,0,0,47,0,-47
27932,1,1,958,1217,259
27933,0,0,39,0,-39
27934,0,0,43,0,-43
27935,1,0,8,0,-8
27936,1,0,71,0,-71
27937,0,0,116,0,-116
27938,1,0,87,0,-87
27939,1,1,258,1282,1024
27940,1,1,50,1243,1193
27941,0,0,2,0,-2
27942,1,0,57,0,-57
27943,0,0,162,0,-162
27944,0,0,122,0,-122
27945,1,0,213,0,-213
27946,1,0,44,0,-44
27947,0,0,161,0,-161
27948,1,1,197,2189,1992
27949,1,0,123,0,-123
27950,1,1,2451,1237,-1214
27951,0,0,2,0,-2
27952,0,0,78,0,-78
27953,0,0,45,0,-45
27954,1,1,552,1205,653
27955,1,0,13,0,-13
27956,0,0,105,0,-105
27957,0,0,16,0,-16
27958,1,0,110,0,-110
27959,1,1,764,2199,1435
27960,0,0,19,0,-19
27961,0,0,143,0,-143
27962,1,1,895,1337,442
27963,1,0,8,0,-8
27964,0,0,4,0,-4
27965,1,1,116,1489,1373
27966,1,1,617,1216,599
27967,0,0,19,0,-19
27968,0,0,1,0,-1
27969,1,1,437,1812,1375
27970,1,0,6,0,-6
27971,0,0,83,0,-83
27972,1,0,91,0,-91
27973,1,1,997,1280,283
27974,1,0,40,0,-40
27975,0,0,71,0,-71
27976,0,0,88,0,-88
27977,1,0,15,0,-15
27978,1,0,0,0,0
27979,1,0,96,0,-96
27980,1,0,2,0,-2
27981,0,0,69,0,-69
27982,0,0,19,0,-19
27983,0,0,63,0,-63
27984,1,1,736,1291,555
27985,0,0,47,0,-47
27986,0,0,69,0,-69
27987,1,0,9,0,-9
27988,1,0,8,0,-8
27989,1,1,1238,1324,86
27990,0,0,23,0,-23
27991,1,0,79,0,-79
27992,1,1,152,1386,1234
27993,1,1,1287,1209,-78
27994,1,1,181,1232,1051
27995,0,0,44,0,-44
27996,0,0,42,0,-42
27997,0,0,42,0,-42
27998,0,0,145,0,-145
27999,1,1,259,1675,1416
28000,1,0,29,0,-29
28001,0,0,78,0,-78
28002,1,1,138,1230,1092
28003,0,0,29,0,-29
28004,0,0,34,0,-34
28005,1,0,25,0,-25
28006,1,0,36,0,-36
28007,1,1,790,1573,783
28008,1,0,30,0,-30
28009,1,0,30,0,-30
28010,1,0,4,0,-4
28011,1,1,233,2616,2383
28012,1,1,495,1260,765
28013,1,0,29,0,-29
28014,1,1,1562,1394,-168
28015,1,0,34,0,-34
28016,1,0,73,0,-73
28017,1,1,1758,1296,-462
28018,1,1,1249,1300,51
28019,1,0,36,0,-36
28020,1,0,0,0,0
28021,1,1,493,1543,1050
28022,1,0,36,0,-36
28023,0,0,4,0,-4
28024,1,0,46,0,-46
28025,1,1,516,1217,701
28026,0,0,39,0,-39
28027,1,0,19,0,-19
28028,1,1,274,1528,1254
28029,1,0,50,0,-50
28030,0,0,45,0,-45
28031,1,1,159,1212,1053
28032,1,0,15,0,-15
28033,0,0,23,0,-23
28034,0,0,13,0,-13
28035,1,0,55,0,-55
28036,1,0,56,0,-56
28037,0,0,13,0,-13
28038,1,1,687,1523,836
28039,0,0,58,0,-58
28040,0,0,30,0,-30
28041,0,0,9,0,-9
28042,1,1,1216,1558,342
28043,0,0,9,0,-9
28044,1,1,307,1351,1044
28045,1,1,153,1903,1750
28046,0,0,17,0,-17
28047,1,1,286,1935,1649
28048,0,0,20,0,-20
28049,1,1,141,1462,1321
28050,1,1,1599,1438,-161
28051,1,1,996,1356,360
28052,1,1,90,1386,1296
28053,1,0,134,0,-134
28054,1,1,36,1201,1165
28055,1,1,295,1829,1534
28056,1,1,622,1312,690
28057,0,0,61,0,-61
28058,0,0,17,0,-17
28059,1,0,75,0,-75
28060,1,0,13,0,-13
28061,1,0,11,0,-11
28062,0,0,2,0,-2
28063,0,0,94,0,-94
28064,0,0,56,0,-56
28065,1,1,681,1909,1228
28066,1,1,393,1237,844
28067,1,0,28,0,-28
28068,1,0,150,0,-150
28069,1,0,80,0,-80
28070,1,1,104,1504,1400
28071,1,0,2,0,-2
28072,0,0,20,0,-20
28073,1,0,42,0,-42
28074,0,0,18,0,-18
28075,0,0,28,0,-28
28076,0,0,152,0,-152
28077,0,0,103,0,-103
28078,1,1,379,1371,992
28079,0,0,6,0,-6
28080,1,1,825,1918,1093
28081,0,0,2,0,-2
28082,1,1,373,1493,1120
28083,1,0,32,0,-32
28084,0,0,18,0,-18
28085,0,0,146,0,-146
28086,0,0,65,0,-65
28087,0,0,57,0,-57
28088,1,0,33,0,-33
28089,1,0,34,0,-34
28090,1,1,790,3850,3060
28091,1,1,715,2945,2230
28092,0,0,65,0,-65
28093,1,1,517,1330,813
28094,1,1,320,1254,934
28095,0,0,13,0,-13
28096,1,0,58,0,-58
28097,0,0,167,0,-167
28098,1,1,259,1728,1469
28099,1,1,115,1569,1454
28100,1,0,0,0,0
28101,0,0,0,0,0
28102,1,0,8,0,-8
28103,0,0,43,0,-43
28104,1,0,104,0,-104
28105,1,1,449,2264,1815
28106,0,0,22,0,-22
28107,1,0,87,0,-87
28108,1,1,229,1356,1127
28109,0,0,55,0,-55
28110,0,0,1,0,-1
28111,1,0,2,0,-2
28112,1,0,6,0,-6
28113,1,1,99,2515,2416
28114,0,0,104,0,-104
28115,0,0,31,0,-31
28116,1,1,289,1309,1020
28117,0,0,68,0,-68
28118,1,1,750,1465,715
28119,1,0,18,0,-18
28120,1,1,1935,2440,505
28121,0,0,26,0,-26
28122,1,1,1249,3018,1769
28123,1,0,1,0,-1
28124,0,0,23,0,-23
28125,0,0,33,0,-33
28126,1,0,15,0,-15
28127,1,0,56,0,-56
28128,1,1,837,1929,1092
28129,1,0,17,0,-17
28130,1,0,24,0,-24
28131,1,1,243,1358,1115
28132,0,0,102,0,-102
28133,1,1,136,1239,1103
28134,1,0,55,0,-55
28135,1,0,1,0,-1
28136,1,0,22,0,-22
28137,1,0,1,0,-1
28138,1,1,675,1229,554
28139,0,0,0,0,0
28140,1,1,246,1220,974
28141,1,0,4,0,-4
28142,1,0,120,0,-120
28143,1,1,117,1582,1465
28144,1,1,188,1382,1194
28145,0,0,53,0,-53
28146,0,0,19,0,-19
28147,1,0,107,0,-107
28148,0,0,20,0,-20
28149,1,1,458,1365,907
28150,0,0,26,0,-26
28151,1,0,17,0,-17
28152,1,0,14,0,-14
28153,1,1,393,1305,912
28154,1,1,44,1215,1171
28155,1,1,104,1277,1173
28156,0,0,23,0,-23
28157,1,0,27,0,-27
28158,0,0,27,0,-27
28159,1,0,98,0,-98
28160,0,0,41,0,-41
28161,0,0,15,0,-15
28162,0,0,15,0,-15
28163,0,0,122,0,-122
28164,1,0,93,0,-93
28165,0,0,7,0,-7
28166,0,0,60,0,-60
28167,1,1,95,1368,1273
28168,1,0,61,0,-61
28169,0,0,104,0,-104
28170,1,0,0,0,0
28171,0,0,129,0,-129
28172,1,0,94,0,-94
28173,1,0,1,0,-1
28174,0,0,19,0,-19
28175,0,0,9,0,-9
28176,0,0,16,0,-16
28177,1,1,162,1423,1261
28178,1,1,872,1468,596
28179,1,1,510,3418,2908
28180,0,0,35,0,-35
28181,1,1,168,1234,1066
28182,0,0,64,0,-64
28183,0,0,126,0,-126
28184,0,0,107,0,-107
28185,1,1,293,2027,1734
28186,0,0,13,0,-13
28187,0,0,6,0,-6
28188,1,0,62,0,-62
28189,1,1,90,1451,1361
28190,1,1,1159,1379,220
28191,0,0,83,0,-83
28192,1,1,1429,1654,225
28193,0,0,89,0,-89
28194,1,1,289,2727,2438
28195,0,0,178,0,-178
28196,0,0,0,0,0
28197,0,0,10,0,-10
28198,0,0,67,0,-67
28199,0,0,47,0,-47
28200,0,0,2,0,-2
28201,0,0,19,0,-19
28202,1,1,218,1623,1405
28203,1,1,768,1404,636
28204,1,0,15,0,-15
28205,1,0,19,0,-19
28206,0,0,82,0,-82
28207,1,1,1327,2534,1207
28208,0,0,5,0,-5
28209,1,0,31,0,-31
28210,1,0,41,0,-41
28211,1,1,679,1243,564
28212,1,1,1715,3487,1772
28213,1,1,412,1255,843
28214,0,0,19,0,-19
28215,0,0,245,0,-245
28216,1,1,403,1266,863
